Vivienda,Salud,Transporte,Educacion,Alimento,Autocuidado,Ingreso_fijo,Clase,id,Fecha,Gasto_var_necesario,Gasto_var_innecesario,Ingreso_variable,Total Out,Total In,Balance
3938,2823,1912,1062,6030,2502,25359,Media-Alta,0,2021-01-31,510,724,8150,19501,33509,14008
1177,850,407,178,3681,599,7369,Baja,1,2021-01-31,143,162,991,7197,8360,1163
2762,1367,874,549,4999,1222,14472,Media-Baja,2,2021-01-31,241,477,4112,12491,18584,6093
4218,2637,2255,1067,4744,2997,32933,Media-Alta,3,2021-01-31,528,878,8187,19324,41120,21796
1353,832,315,177,3263,602,10001,Baja,4,2021-01-31,126,130,831,6798,10832,4034
2742,1703,1077,501,4275,1281,15266,Media-Baja,5,2021-01-31,279,591,4793,12449,20059,7610
2463,1537,948,460,4937,1662,15962,Media-Baja,6,2021-01-31,233,627,4709,12867,20671,7804
4566,3971,2975,2247,8661,4616,85505,Alta,7,2021-01-31,4946,5758,19746,37740,105251,67511
4313,2617,2576,1113,7631,2710,32806,Media-Alta,8,2021-01-31,580,540,6343,22080,39149,17069
4562,3289,3268,2041,8368,4501,78258,Alta,9,2021-01-31,5544,4763,16992,36336,95250,58914
2656,1474,1217,595,5264,1342,17341,Media-Baja,10,2021-01-31,252,573,5211,13373,22552,9179
2320,1591,1205,493,5107,1366,14769,Media-Baja,11,2021-01-31,264,485,4355,12831,19124,6293
2923,1598,1077,613,5352,1400,16037,Media-Baja,12,2021-01-31,240,478,4794,13681,20831,7150
3962,3452,2242,1040,5499,2692,34648,Media-Alta,13,2021-01-31,581,847,8482,20315,43130,22815
2758,1620,964,483,5443,1331,13798,Media-Baja,14,2021-01-31,265,473,4940,13337,18738,5401
1387,598,400,201,4083,640,7498,Baja,15,2021-01-31,168,163,750,7640,8248,608
2419,1539,1132,595,5454,1373,14536,Media-Baja,16,2021-01-31,262,517,5020,13291,19556,6265
2757,1632,956,549,4540,1163,15721,Media-Baja,17,2021-01-31,286,519,4975,12402,20696,8294
2968,1439,904,472,4277,1124,17686,Media-Baja,18,2021-01-31,218,588,5162,11990,22848,10858
2870,1481,997,519,5495,1330,15661,Media-Baja,19,2021-01-31,268,532,4455,13492,20116,6624
2569,1418,866,534,4700,1306,17834,Media-Baja,20,2021-01-31,236,557,4874,12186,22708,10522
3773,2857,2062,1198,5716,2976,29428,Media-Alta,21,2021-01-31,574,902,8816,20058,38244,18186
4671,3760,2101,981,4895,3309,35835,Media-Alta,22,2021-01-31,575,779,8022,21071,43857,22786
2349,1422,1080,517,4728,1652,17283,Media-Baja,23,2021-01-31,249,483,5521,12480,22804,10324
1422,839,378,172,3228,557,8645,Baja,24,2021-01-31,164,157,954,6917,9599,2682
5760,4674,3894,1650,9416,4934,63611,Alta,25,2021-01-31,5455,4578,16356,40361,79967,39606
4231,3154,2447,1216,5928,2747,28664,Media-Alta,26,2021-01-31,465,724,9006,20912,37670,16758
1434,819,367,228,3180,653,8211,Baja,27,2021-01-31,147,171,961,6999,9172,2173
4105,2896,2025,1008,5877,2812,39154,Media-Alta,28,2021-01-31,540,746,8016,20009,47170,27161
1208,719,362,229,3775,698,8956,Baja,29,2021-01-31,166,175,731,7332,9687,2355
2515,1481,1088,449,4106,1535,16394,Media-Baja,30,2021-01-31,307,547,5027,12028,21421,9393
3447,3674,2005,1161,6343,2584,29260,Media-Alta,31,2021-01-31,491,651,7894,20356,37154,16798
1510,843,374,239,3985,538,8152,Baja,32,2021-01-31,153,145,905,7787,9057,1270
5644,4590,3104,1778,9087,4464,62916,Alta,33,2021-01-31,5130,4438,15922,38235,78838,40603
2258,1619,1031,512,3481,1029,16992,Media-Baja,34,2021-01-31,244,571,5547,10745,22539,11794
2596,1738,1092,469,4689,1026,15532,Media-Baja,35,2021-01-31,250,500,4710,12360,20242,7882
2584,1573,851,567,3749,1280,15776,Media-Baja,36,2021-01-31,278,491,4454,11373,20230,8857
2574,1329,1096,605,4581,1325,16039,Media-Baja,37,2021-01-31,240,506,5038,12256,21077,8821
2235,1696,944,445,5230,1375,15525,Media-Baja,38,2021-01-31,248,539,4709,12712,20234,7522
6469,4438,3060,2021,8398,3940,78138,Alta,39,2021-01-31,4914,4433,16151,37673,94289,56616
4872,3264,3683,1755,9347,4370,73689,Alta,40,2021-01-31,5989,5168,18804,38448,92493,54045
5394,4188,3044,1983,10734,4194,70688,Alta,41,2021-01-31,5274,4031,14413,38842,85101,46259
4068,2632,2089,1223,5420,2404,31329,Media-Alta,42,2021-01-31,493,802,8470,19131,39799,20668
5719,4194,3214,1952,7794,3907,83368,Alta,43,2021-01-31,4957,5218,14415,36955,97783,60828
6560,4479,4072,1681,8863,4387,68702,Alta,44,2021-01-31,5831,5050,18883,40923,87585,46662
3560,2822,1859,925,6087,2668,31016,Media-Alta,45,2021-01-31,409,781,7880,19111,38896,19785
3701,2901,1918,1315,5504,2570,29089,Media-Alta,46,2021-01-31,520,717,8288,19146,37377,18231
2454,1544,1067,488,4398,1461,15571,Media-Baja,47,2021-01-31,275,503,4524,12190,20095,7905
2371,1468,1126,542,4135,1152,15088,Media-Baja,48,2021-01-31,251,566,4538,11611,19626,8015
2794,1790,826,422,5371,1557,16358,Media-Baja,49,2021-01-31,283,561,5769,13604,22127,8523
2757,1842,913,498,5188,1304,17385,Media-Baja,50,2021-01-31,246,493,6094,13241,23479,10238
1362,770,318,201,3490,598,9308,Baja,51,2021-01-31,170,185,914,7094,10222,3128
3869,3137,1949,889,5027,2617,34780,Media-Alta,52,2021-01-31,606,781,6975,18875,41755,22880
1350,877,350,183,3540,667,8648,Baja,53,2021-01-31,175,151,865,7293,9513,2220
4301,2797,2272,1134,7122,2251,31540,Media-Alta,54,2021-01-31,563,742,7810,21182,39350,18168
2674,1599,982,554,4062,1356,17288,Media-Baja,55,2021-01-31,272,482,4430,11981,21718,9737
1366,699,355,242,3669,630,8786,Baja,56,2021-01-31,179,171,857,7311,9643,2332
2642,1774,1078,447,4293,1034,15264,Media-Baja,57,2021-01-31,262,589,4694,12119,19958,7839
2437,1934,986,508,4766,1313,17038,Media-Baja,58,2021-01-31,284,525,4841,12753,21879,9126
3267,2609,2148,976,5103,2623,32994,Media-Alta,59,2021-01-31,513,903,6842,18142,39836,21694
2574,1528,1082,705,4757,1243,15421,Media-Baja,60,2021-01-31,268,488,4661,12645,20082,7437
2119,1599,1270,629,4631,1189,14745,Media-Baja,61,2021-01-31,274,536,5023,12247,19768,7521
3500,3109,2018,1132,5955,2431,27324,Media-Alta,62,2021-01-31,535,906,7031,19586,34355,14769
2619,1633,1098,536,5503,1370,14914,Media-Baja,63,2021-01-31,270,475,5080,13504,19994,6490
3811,2759,1797,946,5372,2835,25283,Media-Alta,64,2021-01-31,566,904,8350,18990,33633,14643
4831,2950,2476,998,7017,2081,32381,Media-Alta,65,2021-01-31,459,776,8323,21588,40704,19116
3528,3125,2062,1045,5080,2916,32663,Media-Alta,66,2021-01-31,613,862,8256,19231,40919,21688
4468,3298,2329,1094,6458,2392,29526,Media-Alta,67,2021-01-31,514,774,7388,21327,36914,15587
1275,751,349,213,4145,668,9537,Baja,69,2021-01-31,137,149,838,7687,10375,2688
2605,1808,1173,523,4418,1480,13851,Media-Baja,70,2021-01-31,287,474,5150,12768,19001,6233
5383,4079,3325,2073,8012,3521,66571,Alta,71,2021-01-31,5338,5104,17300,36835,83871,47036
1322,910,350,217,3524,668,8937,Baja,72,2021-01-31,166,171,754,7328,9691,2363
1438,774,444,219,3916,636,8798,Baja,73,2021-01-31,123,155,819,7705,9617,1912
2509,1434,1130,537,4675,906,15028,Media-Baja,74,2021-01-31,294,494,5054,11979,20082,8103
4201,2299,2235,855,6102,2875,29600,Media-Alta,75,2021-01-31,581,748,8032,19896,37632,17736
2811,1675,1043,481,4338,1127,15080,Media-Baja,76,2021-01-31,288,528,5418,12291,20498,8207
2698,1568,1036,537,5275,1484,14625,Media-Baja,77,2021-01-31,258,520,6159,13376,20784,7408
3529,3222,2294,960,6126,2483,29729,Media-Alta,79,2021-01-31,529,808,8346,19951,38075,18124
4077,2667,1800,1223,5065,2455,34261,Media-Alta,80,2021-01-31,508,732,7683,18527,41944,23417
2625,1623,1011,462,4738,1358,17245,Media-Baja,81,2021-01-31,201,531,5574,12549,22819,10270
1147,912,374,233,3674,542,9345,Baja,82,2021-01-31,141,177,786,7200,10131,2931
1401,879,424,220,3060,574,8726,Baja,83,2021-01-31,161,137,815,6856,9541,2685
2613,1445,1089,516,4807,1383,14850,Media-Baja,84,2021-01-31,261,481,4863,12595,19713,7118
1248,785,458,204,3720,740,7952,Baja,85,2021-01-31,146,162,716,7463,8668,1205
1382,601,343,195,3947,718,8352,Baja,86,2021-01-31,140,152,793,7478,9145,1667
3115,1525,1011,517,4691,1400,13794,Media-Baja,87,2021-01-31,259,457,5126,12975,18920,5945
2418,1828,1031,458,5499,1305,14801,Media-Baja,88,2021-01-31,261,562,5470,13362,20271,6909
1182,916,330,212,3390,774,8566,Baja,89,2021-01-31,159,178,928,7141,9494,2353
1227,850,336,239,3517,594,7123,Baja,90,2021-01-31,140,146,845,7049,7968,919
2713,1284,1133,521,4850,1052,15013,Media-Baja,91,2021-01-31,265,550,5056,12368,20069,7701
3646,3031,2443,1236,5828,2713,32098,Media-Alta,92,2021-01-31,524,820,9173,20241,41271,21030
2661,1751,1067,593,5832,1291,15407,Media-Baja,93,2021-01-31,223,531,5287,13949,20694,6745
2543,1592,1205,562,4708,1380,14248,Media-Baja,94,2021-01-31,261,563,4900,12814,19148,6334
3387,1513,1048,572,4847,1557,18280,Media-Baja,95,2021-01-31,264,492,4477,13680,22757,9077
1447,815,381,238,4107,702,8531,Baja,96,2021-01-31,179,153,849,8022,9380,1358
2731,1596,1192,449,3892,1284,14892,Media-Baja,97,2021-01-31,260,563,4859,11967,19751,7784
1215,744,361,184,3250,589,8999,Baja,98,2021-01-31,196,164,734,6703,9733,3030
2800,1486,1010,520,4983,1310,15614,Media-Baja,99,2021-01-31,274,524,5228,12907,20842,7935
3938,2823,1912,1062,6030,2502,25359,Media-Alta,0,2021-02-28,553,813,7912,19633,33271,13638
1177,850,407,178,3681,599,7369,Baja,1,2021-02-28,164,122,820,7178,8189,1011
2762,1367,874,549,4999,1222,14472,Media-Baja,2,2021-02-28,201,561,4317,12535,18789,6254
4218,2637,2255,1067,4744,2997,32933,Media-Alta,3,2021-02-28,581,722,6080,19221,39013,19792
1353,832,315,177,3263,602,10001,Baja,4,2021-02-28,158,121,746,6821,10747,3926
2742,1703,1077,501,4275,1281,15266,Media-Baja,5,2021-02-28,266,555,4451,12400,19717,7317
2463,1537,948,460,4937,1662,15962,Media-Baja,6,2021-02-28,253,516,4790,12776,20752,7976
4566,3971,2975,2247,8661,4616,85505,Alta,7,2021-02-28,5035,5104,20169,37175,105674,68499
4313,2617,2576,1113,7631,2710,32806,Media-Alta,8,2021-02-28,520,850,8744,22330,41550,19220
4562,3289,3268,2041,8368,4501,78258,Alta,9,2021-02-28,5469,4682,16916,36180,95174,58994
2656,1474,1217,595,5264,1342,17341,Media-Baja,10,2021-02-28,251,543,4734,13342,22075,8733
2320,1591,1205,493,5107,1366,14769,Media-Baja,11,2021-02-28,249,558,5716,12889,20485,7596
2923,1598,1077,613,5352,1400,16037,Media-Baja,12,2021-02-28,270,562,5451,13795,21488,7693
3962,3452,2242,1040,5499,2692,34648,Media-Alta,13,2021-02-28,536,764,6413,20187,41061,20874
2758,1620,964,483,5443,1331,13798,Media-Baja,14,2021-02-28,221,523,4516,13343,18314,4971
1387,598,400,201,4083,640,7498,Baja,15,2021-02-28,132,159,965,7600,8463,863
2419,1539,1132,595,5454,1373,14536,Media-Baja,16,2021-02-28,268,573,5109,13353,19645,6292
2757,1632,956,549,4540,1163,15721,Media-Baja,17,2021-02-28,257,520,5210,12374,20931,8557
2968,1439,904,472,4277,1124,17686,Media-Baja,18,2021-02-28,250,524,5392,11958,23078,11120
2870,1481,997,519,5495,1330,15661,Media-Baja,19,2021-02-28,240,458,5100,13390,20761,7371
2569,1418,866,534,4700,1306,17834,Media-Baja,20,2021-02-28,253,492,5535,12138,23369,11231
3773,2857,2062,1198,5716,2976,29428,Media-Alta,21,2021-02-28,549,643,9374,19774,38802,19028
4671,3760,2101,981,4895,3309,35835,Media-Alta,22,2021-02-28,508,780,7871,21005,43706,22701
2349,1422,1080,517,4728,1652,17283,Media-Baja,23,2021-02-28,279,518,5489,12545,22772,10227
1422,839,378,172,3228,557,8645,Baja,24,2021-02-28,136,152,966,6884,9611,2727
5760,4674,3894,1650,9416,4934,63611,Alta,25,2021-02-28,4899,5094,18518,40321,82129,41808
4231,3154,2447,1216,5928,2747,28664,Media-Alta,26,2021-02-28,480,770,7965,20973,36629,15656
1434,819,367,228,3180,653,8211,Baja,27,2021-02-28,183,161,828,7025,9039,2014
4105,2896,2025,1008,5877,2812,39154,Media-Alta,28,2021-02-28,531,750,8925,20004,48079,28075
1208,719,362,229,3775,698,8956,Baja,29,2021-02-28,158,183,895,7332,9851,2519
2515,1481,1088,449,4106,1535,16394,Media-Baja,30,2021-02-28,217,559,4116,11950,20510,8560
3447,3674,2005,1161,6343,2584,29260,Media-Alta,31,2021-02-28,575,908,7821,20697,37081,16384
1510,843,374,239,3985,538,8152,Baja,32,2021-02-28,189,137,805,7815,8957,1142
5644,4590,3104,1778,9087,4464,62916,Alta,33,2021-02-28,5103,4517,19065,38287,81981,43694
2258,1619,1031,512,3481,1029,16992,Media-Baja,34,2021-02-28,269,469,5751,10668,22743,12075
2596,1738,1092,469,4689,1026,15532,Media-Baja,35,2021-02-28,234,447,6201,12291,21733,9442
2584,1573,851,567,3749,1280,15776,Media-Baja,36,2021-02-28,221,568,5081,11393,20857,9464
2574,1329,1096,605,4581,1325,16039,Media-Baja,37,2021-02-28,234,620,5701,12364,21740,9376
2235,1696,944,445,5230,1375,15525,Media-Baja,38,2021-02-28,247,532,5379,12704,20904,8200
6469,4438,3060,2021,8398,3940,78138,Alta,39,2021-02-28,5131,4912,17437,38369,95575,57206
4872,3264,3683,1755,9347,4370,73689,Alta,40,2021-02-28,4622,4113,20001,36026,93690,57664
5394,4188,3044,1983,10734,4194,70688,Alta,41,2021-02-28,5114,5442,16953,40093,87641,47548
4068,2632,2089,1223,5420,2404,31329,Media-Alta,42,2021-02-28,562,865,8081,19263,39410,20147
5719,4194,3214,1952,7794,3907,83368,Alta,43,2021-02-28,5248,4775,18904,36803,102272,65469
6560,4479,4072,1681,8863,4387,68702,Alta,44,2021-02-28,3711,4994,16099,38747,84801,46054
3560,2822,1859,925,6087,2668,31016,Media-Alta,45,2021-02-28,495,795,8655,19211,39671,20460
3701,2901,1918,1315,5504,2570,29089,Media-Alta,46,2021-02-28,544,1058,8941,19511,38030,18519
2454,1544,1067,488,4398,1461,15571,Media-Baja,47,2021-02-28,267,514,4135,12193,19706,7513
2371,1468,1126,542,4135,1152,15088,Media-Baja,48,2021-02-28,267,562,4360,11623,19448,7825
2794,1790,826,422,5371,1557,16358,Media-Baja,49,2021-02-28,246,532,5269,13538,21627,8089
2757,1842,913,498,5188,1304,17385,Media-Baja,50,2021-02-28,271,564,5044,13337,22429,9092
1362,770,318,201,3490,598,9308,Baja,51,2021-02-28,168,177,876,7084,10184,3100
3869,3137,1949,889,5027,2617,34780,Media-Alta,52,2021-02-28,523,725,7882,18736,42662,23926
1350,877,350,183,3540,667,8648,Baja,53,2021-02-28,168,132,695,7267,9343,2076
4301,2797,2272,1134,7122,2251,31540,Media-Alta,54,2021-02-28,555,912,7588,21344,39128,17784
2674,1599,982,554,4062,1356,17288,Media-Baja,55,2021-02-28,242,543,3997,12012,21285,9273
1366,699,355,242,3669,630,8786,Baja,56,2021-02-28,199,176,971,7336,9757,2421
2642,1774,1078,447,4293,1034,15264,Media-Baja,57,2021-02-28,251,575,4539,12094,19803,7709
2437,1934,986,508,4766,1313,17038,Media-Baja,58,2021-02-28,246,551,5395,12741,22433,9692
3267,2609,2148,976,5103,2623,32994,Media-Alta,59,2021-02-28,495,768,8157,17989,41151,23162
2574,1528,1082,705,4757,1243,15421,Media-Baja,60,2021-02-28,274,575,4378,12738,19799,7061
2119,1599,1270,629,4631,1189,14745,Media-Baja,61,2021-02-28,241,598,5021,12276,19766,7490
3500,3109,2018,1132,5955,2431,27324,Media-Alta,62,2021-02-28,550,823,9595,19518,36919,17401
2619,1633,1098,536,5503,1370,14914,Media-Baja,63,2021-02-28,254,514,5486,13527,20400,6873
3811,2759,1797,946,5372,2835,25283,Media-Alta,64,2021-02-28,488,717,7539,18725,32822,14097
4831,2950,2476,998,7017,2081,32381,Media-Alta,65,2021-02-28,538,906,8140,21797,40521,18724
3528,3125,2062,1045,5080,2916,32663,Media-Alta,66,2021-02-28,574,763,8979,19093,41642,22549
4468,3298,2329,1094,6458,2392,29526,Media-Alta,67,2021-02-28,498,901,7196,21438,36722,15284
1275,751,349,213,4145,668,9537,Baja,69,2021-02-28,136,154,831,7691,10368,2677
2605,1808,1173,523,4418,1480,13851,Media-Baja,70,2021-02-28,243,498,4906,12748,18757,6009
5383,4079,3325,2073,8012,3521,66571,Alta,71,2021-02-28,4715,4839,16647,35947,83218,47271
1322,910,350,217,3524,668,8937,Baja,72,2021-02-28,184,145,869,7320,9806,2486
1438,774,444,219,3916,636,8798,Baja,73,2021-02-28,144,157,971,7728,9769,2041
2509,1434,1130,537,4675,906,15028,Media-Baja,74,2021-02-28,283,548,4618,12022,19646,7624
4201,2299,2235,855,6102,2875,29600,Media-Alta,75,2021-02-28,462,877,8512,19906,38112,18206
2811,1675,1043,481,4338,1127,15080,Media-Baja,76,2021-02-28,217,474,4459,12166,19539,7373
2698,1568,1036,537,5275,1484,14625,Media-Baja,77,2021-02-28,285,552,5355,13435,19980,6545
3529,3222,2294,960,6126,2483,29729,Media-Alta,79,2021-02-28,506,845,7328,19965,37057,17092
4077,2667,1800,1223,5065,2455,34261,Media-Alta,80,2021-02-28,567,849,9362,18703,43623,24920
2625,1623,1011,462,4738,1358,17245,Media-Baja,81,2021-02-28,256,518,5108,12591,22353,9762
1147,912,374,233,3674,542,9345,Baja,82,2021-02-28,189,146,744,7217,10089,2872
1401,879,424,220,3060,574,8726,Baja,83,2021-02-28,157,171,951,6886,9677,2791
2613,1445,1089,516,4807,1383,14850,Media-Baja,84,2021-02-28,248,570,5251,12671,20101,7430
1248,785,458,204,3720,740,7952,Baja,85,2021-02-28,138,168,825,7461,8777,1316
1382,601,343,195,3947,718,8352,Baja,86,2021-02-28,175,158,891,7519,9243,1724
3115,1525,1011,517,4691,1400,13794,Media-Baja,87,2021-02-28,277,533,5058,13069,18852,5783
2418,1828,1031,458,5499,1305,14801,Media-Baja,88,2021-02-28,289,511,4493,13339,19294,5955
1182,916,330,212,3390,774,8566,Baja,89,2021-02-28,164,153,836,7121,9402,2281
1227,850,336,239,3517,594,7123,Baja,90,2021-02-28,144,139,802,7046,7925,879
2713,1284,1133,521,4850,1052,15013,Media-Baja,91,2021-02-28,267,544,5201,12364,20214,7850
3646,3031,2443,1236,5828,2713,32098,Media-Alta,92,2021-02-28,549,877,7609,20323,39707,19384
2661,1751,1067,593,5832,1291,15407,Media-Baja,93,2021-02-28,246,441,4600,13882,20007,6125
2543,1592,1205,562,4708,1380,14248,Media-Baja,94,2021-02-28,267,508,4420,12765,18668,5903
3387,1513,1048,572,4847,1557,18280,Media-Baja,95,2021-02-28,277,515,3774,13716,22054,8338
1447,815,381,238,4107,702,8531,Baja,96,2021-02-28,175,146,930,8011,9461,1450
2731,1596,1192,449,3892,1284,14892,Media-Baja,97,2021-02-28,294,513,5239,11951,20131,8180
1215,744,361,184,3250,589,8999,Baja,98,2021-02-28,154,177,801,6674,9800,3126
2800,1486,1010,520,4983,1310,15614,Media-Baja,99,2021-02-28,252,500,5089,12861,20703,7842
3938,2823,1912,1062,6030,2502,25359,Media-Alta,0,2021-03-31,515,725,7870,19507,33229,13722
1177,850,407,178,3681,599,7369,Baja,1,2021-03-31,158,135,802,7185,8171,986
2762,1367,874,549,4999,1222,14472,Media-Baja,2,2021-03-31,239,595,5443,12607,19915,7308
4218,2637,2255,1067,4744,2997,32933,Media-Alta,3,2021-03-31,498,748,9162,19164,42095,22931
1353,832,315,177,3263,602,10001,Baja,4,2021-03-31,143,166,937,6851,10938,4087
2742,1703,1077,501,4275,1281,15266,Media-Baja,5,2021-03-31,308,526,4414,12413,19680,7267
2463,1537,948,460,4937,1662,15962,Media-Baja,6,2021-03-31,310,492,5381,12809,21343,8534
4566,3971,2975,2247,8661,4616,85505,Alta,7,2021-03-31,5275,4609,16213,36920,101718,64798
4313,2617,2576,1113,7631,2710,32806,Media-Alta,8,2021-03-31,496,830,7644,22286,40450,18164
4562,3289,3268,2041,8368,4501,78258,Alta,9,2021-03-31,5459,4424,18742,35912,97000,61088
2656,1474,1217,595,5264,1342,17341,Media-Baja,10,2021-03-31,244,480,4363,13272,21704,8432
2320,1591,1205,493,5107,1366,14769,Media-Baja,11,2021-03-31,311,435,4624,12828,19393,6565
2923,1598,1077,613,5352,1400,16037,Media-Baja,12,2021-03-31,288,416,5266,13667,21303,7636
3962,3452,2242,1040,5499,2692,34648,Media-Alta,13,2021-03-31,567,733,8091,20187,42739,22552
2758,1620,964,483,5443,1331,13798,Media-Baja,14,2021-03-31,234,550,5090,13383,18888,5505
1387,598,400,201,4083,640,7498,Baja,15,2021-03-31,172,172,955,7653,8453,800
2419,1539,1132,595,5454,1373,14536,Media-Baja,16,2021-03-31,256,499,4663,13267,19199,5932
2757,1632,956,549,4540,1163,15721,Media-Baja,17,2021-03-31,272,497,4338,12366,20059,7693
2968,1439,904,472,4277,1124,17686,Media-Baja,18,2021-03-31,249,522,5117,11955,22803,10848
2870,1481,997,519,5495,1330,15661,Media-Baja,19,2021-03-31,195,574,5085,13461,20746,7285
2569,1418,866,534,4700,1306,17834,Media-Baja,20,2021-03-31,299,553,5645,12245,23479,11234
3773,2857,2062,1198,5716,2976,29428,Media-Alta,21,2021-03-31,392,616,8115,19590,37543,17953
4671,3760,2101,981,4895,3309,35835,Media-Alta,22,2021-03-31,462,785,7590,20964,43425,22461
2349,1422,1080,517,4728,1652,17283,Media-Baja,23,2021-03-31,256,675,4929,12679,22212,9533
1422,839,378,172,3228,557,8645,Baja,24,2021-03-31,132,157,755,6885,9400,2515
5760,4674,3894,1650,9416,4934,63611,Alta,25,2021-03-31,5427,4281,17305,40036,80916,40880
4231,3154,2447,1216,5928,2747,28664,Media-Alta,26,2021-03-31,484,819,6857,21026,35521,14495
1434,819,367,228,3180,653,8211,Baja,27,2021-03-31,147,182,875,7010,9086,2076
4105,2896,2025,1008,5877,2812,39154,Media-Alta,28,2021-03-31,495,700,8821,19918,47975,28057
1208,719,362,229,3775,698,8956,Baja,29,2021-03-31,161,163,956,7315,9912,2597
2515,1481,1088,449,4106,1535,16394,Media-Baja,30,2021-03-31,278,505,5958,11957,22352,10395
3447,3674,2005,1161,6343,2584,29260,Media-Alta,31,2021-03-31,552,805,8654,20571,37914,17343
1510,843,374,239,3985,538,8152,Baja,32,2021-03-31,151,137,802,7777,8954,1177
5644,4590,3104,1778,9087,4464,62916,Alta,33,2021-03-31,4960,4485,19589,38112,82505,44393
2258,1619,1031,512,3481,1029,16992,Media-Baja,34,2021-03-31,247,557,4465,10734,21457,10723
2596,1738,1092,469,4689,1026,15532,Media-Baja,35,2021-03-31,262,526,4543,12398,20075,7677
2584,1573,851,567,3749,1280,15776,Media-Baja,36,2021-03-31,237,437,5213,11278,20989,9711
2574,1329,1096,605,4581,1325,16039,Media-Baja,37,2021-03-31,236,506,5784,12252,21823,9571
2235,1696,944,445,5230,1375,15525,Media-Baja,38,2021-03-31,258,550,5157,12733,20682,7949
6469,4438,3060,2021,8398,3940,78138,Alta,39,2021-03-31,5111,5081,18806,38518,96944,58426
4872,3264,3683,1755,9347,4370,73689,Alta,40,2021-03-31,5177,4660,16661,37128,90350,53222
5394,4188,3044,1983,10734,4194,70688,Alta,41,2021-03-31,4543,4622,14871,38702,85559,46857
4068,2632,2089,1223,5420,2404,31329,Media-Alta,42,2021-03-31,618,855,7459,19309,38788,19479
5719,4194,3214,1952,7794,3907,83368,Alta,43,2021-03-31,5231,4329,17170,36340,100538,64198
6560,4479,4072,1681,8863,4387,68702,Alta,44,2021-03-31,5841,4606,16690,40489,85392,44903
3560,2822,1859,925,6087,2668,31016,Media-Alta,45,2021-03-31,573,875,7783,19369,38799,19430
3701,2901,1918,1315,5504,2570,29089,Media-Alta,46,2021-03-31,599,865,8093,19373,37182,17809
2454,1544,1067,488,4398,1461,15571,Media-Baja,47,2021-03-31,243,542,4825,12197,20396,8199
2371,1468,1126,542,4135,1152,15088,Media-Baja,48,2021-03-31,201,553,4469,11548,19557,8009
2794,1790,826,422,5371,1557,16358,Media-Baja,49,2021-03-31,259,505,5131,13524,21489,7965
2757,1842,913,498,5188,1304,17385,Media-Baja,50,2021-03-31,248,558,5850,13308,23235,9927
1362,770,318,201,3490,598,9308,Baja,51,2021-03-31,180,156,729,7075,10037,2962
3869,3137,1949,889,5027,2617,34780,Media-Alta,52,2021-03-31,514,812,8010,18814,42790,23976
1350,877,350,183,3540,667,8648,Baja,53,2021-03-31,156,152,814,7275,9462,2187
4301,2797,2272,1134,7122,2251,31540,Media-Alta,54,2021-03-31,536,758,7919,21171,39459,18288
2674,1599,982,554,4062,1356,17288,Media-Baja,55,2021-03-31,273,543,5631,12043,22919,10876
1366,699,355,242,3669,630,8786,Baja,56,2021-03-31,151,160,997,7272,9783,2511
2642,1774,1078,447,4293,1034,15264,Media-Baja,57,2021-03-31,266,536,5200,12070,20464,8394
2437,1934,986,508,4766,1313,17038,Media-Baja,58,2021-03-31,238,430,5395,12612,22433,9821
3267,2609,2148,976,5103,2623,32994,Media-Alta,59,2021-03-31,526,809,8271,18061,41265,23204
2574,1528,1082,705,4757,1243,15421,Media-Baja,60,2021-03-31,271,512,4760,12672,20181,7509
2119,1599,1270,629,4631,1189,14745,Media-Baja,61,2021-03-31,267,428,4490,12132,19235,7103
3500,3109,2018,1132,5955,2431,27324,Media-Alta,62,2021-03-31,547,929,9688,19621,37012,17391
2619,1633,1098,536,5503,1370,14914,Media-Baja,63,2021-03-31,255,504,5160,13518,20074,6556
3811,2759,1797,946,5372,2835,25283,Media-Alta,64,2021-03-31,542,775,7899,18837,33182,14345
4831,2950,2476,998,7017,2081,32381,Media-Alta,65,2021-03-31,604,753,7840,21710,40221,18511
3528,3125,2062,1045,5080,2916,32663,Media-Alta,66,2021-03-31,501,796,7489,19053,40152,21099
4468,3298,2329,1094,6458,2392,29526,Media-Alta,67,2021-03-31,487,807,6179,21333,35705,14372
1275,751,349,213,4145,668,9537,Baja,69,2021-03-31,205,146,907,7752,10444,2692
2605,1808,1173,523,4418,1480,13851,Media-Baja,70,2021-03-31,222,504,4445,12733,18296,5563
5383,4079,3325,2073,8012,3521,66571,Alta,71,2021-03-31,5444,5241,21772,37078,88343,51265
1322,910,350,217,3524,668,8937,Baja,72,2021-03-31,153,140,840,7284,9777,2493
1438,774,444,219,3916,636,8798,Baja,73,2021-03-31,153,168,931,7748,9729,1981
2509,1434,1130,537,4675,906,15028,Media-Baja,74,2021-03-31,242,462,4691,11895,19719,7824
4201,2299,2235,855,6102,2875,29600,Media-Alta,75,2021-03-31,543,724,9539,19834,39139,19305
2811,1675,1043,481,4338,1127,15080,Media-Baja,76,2021-03-31,302,543,3810,12320,18890,6570
2698,1568,1036,537,5275,1484,14625,Media-Baja,77,2021-03-31,259,453,5389,13310,20014,6704
3529,3222,2294,960,6126,2483,29729,Media-Alta,79,2021-03-31,547,708,7263,19869,36992,17123
4077,2667,1800,1223,5065,2455,34261,Media-Alta,80,2021-03-31,573,739,7991,18599,42252,23653
2625,1623,1011,462,4738,1358,17245,Media-Baja,81,2021-03-31,254,577,4968,12648,22213,9565
1147,912,374,233,3674,542,9345,Baja,82,2021-03-31,166,128,914,7176,10259,3083
1401,879,424,220,3060,574,8726,Baja,83,2021-03-31,152,157,894,6867,9620,2753
2613,1445,1089,516,4807,1383,14850,Media-Baja,84,2021-03-31,199,607,6063,12659,20913,8254
1248,785,458,204,3720,740,7952,Baja,85,2021-03-31,130,136,828,7421,8780,1359
1382,601,343,195,3947,718,8352,Baja,86,2021-03-31,144,155,811,7485,9163,1678
3115,1525,1011,517,4691,1400,13794,Media-Baja,87,2021-03-31,253,561,5323,13073,19117,6044
2418,1828,1031,458,5499,1305,14801,Media-Baja,88,2021-03-31,305,512,4337,13356,19138,5782
1182,916,330,212,3390,774,8566,Baja,89,2021-03-31,179,166,893,7149,9459,2310
1227,850,336,239,3517,594,7123,Baja,90,2021-03-31,162,163,851,7088,7974,886
2713,1284,1133,521,4850,1052,15013,Media-Baja,91,2021-03-31,253,489,4986,12295,19999,7704
3646,3031,2443,1236,5828,2713,32098,Media-Alta,92,2021-03-31,556,619,7575,20072,39673,19601
2661,1751,1067,593,5832,1291,15407,Media-Baja,93,2021-03-31,258,536,5166,13989,20573,6584
2543,1592,1205,562,4708,1380,14248,Media-Baja,94,2021-03-31,225,558,5562,12773,19810,7037
3387,1513,1048,572,4847,1557,18280,Media-Baja,95,2021-03-31,290,522,4613,13736,22893,9157
1447,815,381,238,4107,702,8531,Baja,96,2021-03-31,122,180,769,7992,9300,1308
2731,1596,1192,449,3892,1284,14892,Media-Baja,97,2021-03-31,248,528,4427,11920,19319,7399
1215,744,361,184,3250,589,8999,Baja,98,2021-03-31,143,174,902,6660,9901,3241
2800,1486,1010,520,4983,1310,15614,Media-Baja,99,2021-03-31,239,461,4267,12809,19881,7072
3938,2823,1912,1062,6030,2502,25359,Media-Alta,0,2021-04-30,489,924,8531,19680,33890,14210
1177,850,407,178,3681,599,7369,Baja,1,2021-04-30,126,158,692,7176,8061,885
2762,1367,874,549,4999,1222,14472,Media-Baja,2,2021-04-30,230,517,4941,12520,19413,6893
4218,2637,2255,1067,4744,2997,32933,Media-Alta,3,2021-04-30,496,937,9003,19351,41936,22585
1353,832,315,177,3263,602,10001,Baja,4,2021-04-30,162,134,789,6838,10790,3952
2742,1703,1077,501,4275,1281,15266,Media-Baja,5,2021-04-30,248,561,4927,12388,20193,7805
2463,1537,948,460,4937,1662,15962,Media-Baja,6,2021-04-30,308,473,4721,12788,20683,7895
4566,3971,2975,2247,8661,4616,85505,Alta,7,2021-04-30,5354,3720,13727,36110,99232,63122
4313,2617,2576,1113,7631,2710,32806,Media-Alta,8,2021-04-30,542,806,8674,22308,41480,19172
4562,3289,3268,2041,8368,4501,78258,Alta,9,2021-04-30,4994,5410,18931,36433,97189,60756
2656,1474,1217,595,5264,1342,17341,Media-Baja,10,2021-04-30,214,549,5712,13311,23053,9742
2320,1591,1205,493,5107,1366,14769,Media-Baja,11,2021-04-30,279,529,4477,12890,19246,6356
2923,1598,1077,613,5352,1400,16037,Media-Baja,12,2021-04-30,257,498,5464,13718,21501,7783
3962,3452,2242,1040,5499,2692,34648,Media-Alta,13,2021-04-30,544,796,8083,20227,42731,22504
2758,1620,964,483,5443,1331,13798,Media-Baja,14,2021-04-30,256,518,5230,13373,19028,5655
1387,598,400,201,4083,640,7498,Baja,15,2021-04-30,166,141,729,7616,8227,611
2419,1539,1132,595,5454,1373,14536,Media-Baja,16,2021-04-30,240,541,5033,13293,19569,6276
2757,1632,956,549,4540,1163,15721,Media-Baja,17,2021-04-30,230,575,4334,12402,20055,7653
2968,1439,904,472,4277,1124,17686,Media-Baja,18,2021-04-30,260,555,5252,11999,22938,10939
2870,1481,997,519,5495,1330,15661,Media-Baja,19,2021-04-30,239,563,5357,13494,21018,7524
2569,1418,866,534,4700,1306,17834,Media-Baja,20,2021-04-30,247,443,4815,12083,22649,10566
3773,2857,2062,1198,5716,2976,29428,Media-Alta,21,2021-04-30,493,789,8280,19864,37708,17844
4671,3760,2101,981,4895,3309,35835,Media-Alta,22,2021-04-30,554,831,6134,21102,41969,20867
2349,1422,1080,517,4728,1652,17283,Media-Baja,23,2021-04-30,259,571,5607,12578,22890,10312
1422,839,378,172,3228,557,8645,Baja,24,2021-04-30,166,170,910,6932,9555,2623
5760,4674,3894,1650,9416,4934,63611,Alta,25,2021-04-30,5131,4427,13748,39886,77359,37473
4231,3154,2447,1216,5928,2747,28664,Media-Alta,26,2021-04-30,491,790,9764,21004,38428,17424
1434,819,367,228,3180,653,8211,Baja,27,2021-04-30,164,172,853,7017,9064,2047
4105,2896,2025,1008,5877,2812,39154,Media-Alta,28,2021-04-30,482,752,6526,19957,45680,25723
1208,719,362,229,3775,698,8956,Baja,29,2021-04-30,145,163,780,7299,9736,2437
2515,1481,1088,449,4106,1535,16394,Media-Baja,30,2021-04-30,240,496,5556,11910,21950,10040
3447,3674,2005,1161,6343,2584,29260,Media-Alta,31,2021-04-30,585,911,5707,20710,34967,14257
1510,843,374,239,3985,538,8152,Baja,32,2021-04-30,151,178,970,7818,9122,1304
5644,4590,3104,1778,9087,4464,62916,Alta,33,2021-04-30,6607,5258,17076,40532,79992,39460
2258,1619,1031,512,3481,1029,16992,Media-Baja,34,2021-04-30,281,464,4502,10675,21494,10819
2596,1738,1092,469,4689,1026,15532,Media-Baja,35,2021-04-30,272,541,5221,12423,20753,8330
2584,1573,851,567,3749,1280,15776,Media-Baja,36,2021-04-30,265,512,4721,11381,20497,9116
2574,1329,1096,605,4581,1325,16039,Media-Baja,37,2021-04-30,259,520,5368,12289,21407,9118
2235,1696,944,445,5230,1375,15525,Media-Baja,38,2021-04-30,259,463,6313,12647,21838,9191
6469,4438,3060,2021,8398,3940,78138,Alta,39,2021-04-30,5491,5158,18689,38975,96827,57852
4872,3264,3683,1755,9347,4370,73689,Alta,40,2021-04-30,5382,5130,16140,37803,89829,52026
5394,4188,3044,1983,10734,4194,70688,Alta,41,2021-04-30,5289,4907,20634,39733,91322,51589
4068,2632,2089,1223,5420,2404,31329,Media-Alta,42,2021-04-30,560,808,7095,19204,38424,19220
5719,4194,3214,1952,7794,3907,83368,Alta,43,2021-04-30,4613,4963,19072,36356,102440,66084
6560,4479,4072,1681,8863,4387,68702,Alta,44,2021-04-30,5392,4523,16596,39957,85298,45341
3560,2822,1859,925,6087,2668,31016,Media-Alta,45,2021-04-30,493,826,8157,19240,39173,19933
3701,2901,1918,1315,5504,2570,29089,Media-Alta,46,2021-04-30,434,686,8209,19029,37298,18269
2454,1544,1067,488,4398,1461,15571,Media-Baja,47,2021-04-30,287,515,5201,12214,20772,8558
2371,1468,1126,542,4135,1152,15088,Media-Baja,48,2021-04-30,241,476,6603,11511,21691,10180
2794,1790,826,422,5371,1557,16358,Media-Baja,49,2021-04-30,265,600,4445,13625,20803,7178
2757,1842,913,498,5188,1304,17385,Media-Baja,50,2021-04-30,281,549,4518,13332,21903,8571
1362,770,318,201,3490,598,9308,Baja,51,2021-04-30,157,143,920,7039,10228,3189
3869,3137,1949,889,5027,2617,34780,Media-Alta,52,2021-04-30,536,837,8101,18861,42881,24020
1350,877,350,183,3540,667,8648,Baja,53,2021-04-30,155,164,784,7286,9432,2146
4301,2797,2272,1134,7122,2251,31540,Media-Alta,54,2021-04-30,613,727,6015,21217,37555,16338
2674,1599,982,554,4062,1356,17288,Media-Baja,55,2021-04-30,283,481,5293,11991,22581,10590
1366,699,355,242,3669,630,8786,Baja,56,2021-04-30,148,194,719,7303,9505,2202
2642,1774,1078,447,4293,1034,15264,Media-Baja,57,2021-04-30,284,521,4784,12073,20048,7975
2437,1934,986,508,4766,1313,17038,Media-Baja,58,2021-04-30,280,550,4261,12774,21299,8525
3267,2609,2148,976,5103,2623,32994,Media-Alta,59,2021-04-30,602,739,8450,18067,41444,23377
2574,1528,1082,705,4757,1243,15421,Media-Baja,60,2021-04-30,253,528,5353,12670,20774,8104
2119,1599,1270,629,4631,1189,14745,Media-Baja,61,2021-04-30,296,487,4708,12220,19453,7233
3500,3109,2018,1132,5955,2431,27324,Media-Alta,62,2021-04-30,530,742,8947,19417,36271,16854
2619,1633,1098,536,5503,1370,14914,Media-Baja,63,2021-04-30,285,488,4694,13532,19608,6076
3811,2759,1797,946,5372,2835,25283,Media-Alta,64,2021-04-30,525,709,6409,18754,31692,12938
4831,2950,2476,998,7017,2081,32381,Media-Alta,65,2021-04-30,498,779,8388,21630,40769,19139
3528,3125,2062,1045,5080,2916,32663,Media-Alta,66,2021-04-30,600,742,9022,19098,41685,22587
4468,3298,2329,1094,6458,2392,29526,Media-Alta,67,2021-04-30,465,672,7533,21176,37059,15883
1275,751,349,213,4145,668,9537,Baja,69,2021-04-30,163,172,721,7736,10258,2522
2605,1808,1173,523,4418,1480,13851,Media-Baja,70,2021-04-30,246,599,3915,12852,17766,4914
5383,4079,3325,2073,8012,3521,66571,Alta,71,2021-04-30,5698,4662,17698,36753,84269,47516
1322,910,350,217,3524,668,8937,Baja,72,2021-04-30,142,145,881,7278,9818,2540
1438,774,444,219,3916,636,8798,Baja,73,2021-04-30,166,155,833,7748,9631,1883
2509,1434,1130,537,4675,906,15028,Media-Baja,74,2021-04-30,284,512,5331,11987,20359,8372
4201,2299,2235,855,6102,2875,29600,Media-Alta,75,2021-04-30,497,969,8751,20033,38351,18318
2811,1675,1043,481,4338,1127,15080,Media-Baja,76,2021-04-30,300,517,4948,12292,20028,7736
2698,1568,1036,537,5275,1484,14625,Media-Baja,77,2021-04-30,277,559,4631,13434,19256,5822
3529,3222,2294,960,6126,2483,29729,Media-Alta,79,2021-04-30,504,668,7703,19786,37432,17646
4077,2667,1800,1223,5065,2455,34261,Media-Alta,80,2021-04-30,553,685,8459,18525,42720,24195
2625,1623,1011,462,4738,1358,17245,Media-Baja,81,2021-04-30,275,494,5207,12586,22452,9866
1147,912,374,233,3674,542,9345,Baja,82,2021-04-30,140,162,912,7184,10257,3073
1401,879,424,220,3060,574,8726,Baja,83,2021-04-30,125,159,754,6842,9480,2638
2613,1445,1089,516,4807,1383,14850,Media-Baja,84,2021-04-30,225,497,4755,12575,19605,7030
1248,785,458,204,3720,740,7952,Baja,85,2021-04-30,143,179,895,7477,8847,1370
1382,601,343,195,3947,718,8352,Baja,86,2021-04-30,171,138,818,7495,9170,1675
3115,1525,1011,517,4691,1400,13794,Media-Baja,87,2021-04-30,233,572,4662,13064,18456,5392
2418,1828,1031,458,5499,1305,14801,Media-Baja,88,2021-04-30,302,581,5403,13422,20204,6782
1182,916,330,212,3390,774,8566,Baja,89,2021-04-30,165,156,795,7125,9361,2236
1227,850,336,239,3517,594,7123,Baja,90,2021-04-30,151,157,861,7071,7984,913
2713,1284,1133,521,4850,1052,15013,Media-Baja,91,2021-04-30,266,514,4914,12333,19927,7594
3646,3031,2443,1236,5828,2713,32098,Media-Alta,92,2021-04-30,629,759,6972,20285,39070,18785
2661,1751,1067,593,5832,1291,15407,Media-Baja,93,2021-04-30,274,521,5446,13990,20853,6863
2543,1592,1205,562,4708,1380,14248,Media-Baja,94,2021-04-30,292,526,4401,12808,18649,5841
3387,1513,1048,572,4847,1557,18280,Media-Baja,95,2021-04-30,251,505,5195,13680,23475,9795
1447,815,381,238,4107,702,8531,Baja,96,2021-04-30,141,157,891,7988,9422,1434
2731,1596,1192,449,3892,1284,14892,Media-Baja,97,2021-04-30,270,611,4476,12025,19368,7343
1215,744,361,184,3250,589,8999,Baja,98,2021-04-30,154,164,830,6661,9829,3168
2800,1486,1010,520,4983,1310,15614,Media-Baja,99,2021-04-30,250,477,5183,12836,20797,7961
3938,2823,1912,1062,6030,2502,25359,Media-Alta,0,2021-05-31,523,723,8939,19513,34298,14785
1177,850,407,178,3681,599,7369,Baja,1,2021-05-31,133,191,639,7216,8008,792
2762,1367,874,549,4999,1222,14472,Media-Baja,2,2021-05-31,261,505,4891,12539,19363,6824
4218,2637,2255,1067,4744,2997,32933,Media-Alta,3,2021-05-31,495,729,8166,19142,41099,21957
1353,832,315,177,3263,602,10001,Baja,4,2021-05-31,132,155,915,6829,10916,4087
2742,1703,1077,501,4275,1281,15266,Media-Baja,5,2021-05-31,275,634,4504,12488,19770,7282
2463,1537,948,460,4937,1662,15962,Media-Baja,6,2021-05-31,297,534,5286,12838,21248,8410
4566,3971,2975,2247,8661,4616,85505,Alta,7,2021-05-31,4482,4429,15377,35947,100882,64935
4313,2617,2576,1113,7631,2710,32806,Media-Alta,8,2021-05-31,528,756,6824,22244,39630,17386
4562,3289,3268,2041,8368,4501,78258,Alta,9,2021-05-31,5991,4048,17926,36068,96184,60116
2656,1474,1217,595,5264,1342,17341,Media-Baja,10,2021-05-31,257,422,4769,13227,22110,8883
2320,1591,1205,493,5107,1366,14769,Media-Baja,11,2021-05-31,253,479,5151,12814,19920,7106
2923,1598,1077,613,5352,1400,16037,Media-Baja,12,2021-05-31,233,590,4768,13786,20805,7019
3962,3452,2242,1040,5499,2692,34648,Media-Alta,13,2021-05-31,467,725,8228,20079,42876,22797
2758,1620,964,483,5443,1331,13798,Media-Baja,14,2021-05-31,273,466,4288,13338,18086,4748
1387,598,400,201,4083,640,7498,Baja,15,2021-05-31,164,164,925,7637,8423,786
2419,1539,1132,595,5454,1373,14536,Media-Baja,16,2021-05-31,284,557,5359,13353,19895,6542
2757,1632,956,549,4540,1163,15721,Media-Baja,17,2021-05-31,246,585,5646,12428,21367,8939
2968,1439,904,472,4277,1124,17686,Media-Baja,18,2021-05-31,272,507,5753,11963,23439,11476
2870,1481,997,519,5495,1330,15661,Media-Baja,19,2021-05-31,276,550,5182,13518,20843,7325
2569,1418,866,534,4700,1306,17834,Media-Baja,20,2021-05-31,233,648,4584,12274,22418,10144
3773,2857,2062,1198,5716,2976,29428,Media-Alta,21,2021-05-31,538,734,7103,19854,36531,16677
4671,3760,2101,981,4895,3309,35835,Media-Alta,22,2021-05-31,566,722,8001,21005,43836,22831
2349,1422,1080,517,4728,1652,17283,Media-Baja,23,2021-05-31,294,514,5285,12556,22568,10012
1422,839,378,172,3228,557,8645,Baja,24,2021-05-31,124,178,905,6898,9550,2652
5760,4674,3894,1650,9416,4934,63611,Alta,25,2021-05-31,5290,4332,15741,39950,79352,39402
4231,3154,2447,1216,5928,2747,28664,Media-Alta,26,2021-05-31,494,912,8934,21129,37598,16469
1434,819,367,228,3180,653,8211,Baja,27,2021-05-31,134,130,939,6945,9150,2205
4105,2896,2025,1008,5877,2812,39154,Media-Alta,28,2021-05-31,592,892,8446,20207,47600,27393
1208,719,362,229,3775,698,8956,Baja,29,2021-05-31,149,147,937,7287,9893,2606
2515,1481,1088,449,4106,1535,16394,Media-Baja,30,2021-05-31,279,467,4927,11920,21321,9401
3447,3674,2005,1161,6343,2584,29260,Media-Alta,31,2021-05-31,507,731,7572,20452,36832,16380
1510,843,374,239,3985,538,8152,Baja,32,2021-05-31,165,174,881,7828,9033,1205
5644,4590,3104,1778,9087,4464,62916,Alta,33,2021-05-31,5908,5098,13585,39673,76501,36828
2258,1619,1031,512,3481,1029,16992,Media-Baja,34,2021-05-31,262,434,4496,10626,21488,10862
2596,1738,1092,469,4689,1026,15532,Media-Baja,35,2021-05-31,305,453,4775,12368,20307,7939
2584,1573,851,567,3749,1280,15776,Media-Baja,36,2021-05-31,274,533,5597,11411,21373,9962
2574,1329,1096,605,4581,1325,16039,Media-Baja,37,2021-05-31,248,619,5617,12377,21656,9279
2235,1696,944,445,5230,1375,15525,Media-Baja,38,2021-05-31,237,526,5083,12688,20608,7920
6469,4438,3060,2021,8398,3940,78138,Alta,39,2021-05-31,6085,5330,14743,39741,92881,53140
4872,3264,3683,1755,9347,4370,73689,Alta,40,2021-05-31,4454,5527,18344,37272,92033,54761
5394,4188,3044,1983,10734,4194,70688,Alta,41,2021-05-31,5032,5218,14487,39787,85175,45388
4068,2632,2089,1223,5420,2404,31329,Media-Alta,42,2021-05-31,514,785,6586,19135,37915,18780
5719,4194,3214,1952,7794,3907,83368,Alta,43,2021-05-31,3958,4532,14794,35270,98162,62892
6560,4479,4072,1681,8863,4387,68702,Alta,44,2021-05-31,5502,4465,14004,40009,82706,42697
3560,2822,1859,925,6087,2668,31016,Media-Alta,45,2021-05-31,528,575,8163,19024,39179,20155
3701,2901,1918,1315,5504,2570,29089,Media-Alta,46,2021-05-31,552,963,7552,19424,36641,17217
2454,1544,1067,488,4398,1461,15571,Media-Baja,47,2021-05-31,283,525,4822,12220,20393,8173
2371,1468,1126,542,4135,1152,15088,Media-Baja,48,2021-05-31,264,422,5130,11480,20218,8738
2794,1790,826,422,5371,1557,16358,Media-Baja,49,2021-05-31,264,532,4496,13556,20854,7298
2757,1842,913,498,5188,1304,17385,Media-Baja,50,2021-05-31,225,532,5155,13259,22540,9281
1362,770,318,201,3490,598,9308,Baja,51,2021-05-31,151,176,921,7066,10229,3163
3869,3137,1949,889,5027,2617,34780,Media-Alta,52,2021-05-31,571,648,8737,18707,43517,24810
1350,877,350,183,3540,667,8648,Baja,53,2021-05-31,160,175,910,7302,9558,2256
4301,2797,2272,1134,7122,2251,31540,Media-Alta,54,2021-05-31,519,707,7656,21103,39196,18093
2674,1599,982,554,4062,1356,17288,Media-Baja,55,2021-05-31,256,589,4892,12072,22180,10108
1366,699,355,242,3669,630,8786,Baja,56,2021-05-31,153,123,764,7237,9550,2313
2642,1774,1078,447,4293,1034,15264,Media-Baja,57,2021-05-31,289,583,5843,12140,21107,8967
2437,1934,986,508,4766,1313,17038,Media-Baja,58,2021-05-31,276,453,4711,12673,21749,9076
3267,2609,2148,976,5103,2623,32994,Media-Alta,59,2021-05-31,568,732,8598,18026,41592,23566
2574,1528,1082,705,4757,1243,15421,Media-Baja,60,2021-05-31,276,521,5207,12686,20628,7942
2119,1599,1270,629,4631,1189,14745,Media-Baja,61,2021-05-31,265,465,4441,12167,19186,7019
3500,3109,2018,1132,5955,2431,27324,Media-Alta,62,2021-05-31,626,771,7822,19542,35146,15604
2619,1633,1098,536,5503,1370,14914,Media-Baja,63,2021-05-31,253,541,4927,13553,19841,6288
3811,2759,1797,946,5372,2835,25283,Media-Alta,64,2021-05-31,555,947,8058,19022,33341,14319
4831,2950,2476,998,7017,2081,32381,Media-Alta,65,2021-05-31,591,797,7923,21741,40304,18563
3528,3125,2062,1045,5080,2916,32663,Media-Alta,66,2021-05-31,588,824,8147,19168,40810,21642
4468,3298,2329,1094,6458,2392,29526,Media-Alta,67,2021-05-31,502,868,9078,21409,38604,17195
1275,751,349,213,4145,668,9537,Baja,69,2021-05-31,153,144,921,7698,10458,2760
2605,1808,1173,523,4418,1480,13851,Media-Baja,70,2021-05-31,285,594,5415,12886,19266,6380
5383,4079,3325,2073,8012,3521,66571,Alta,71,2021-05-31,4642,4822,18713,35857,85284,49427
1322,910,350,217,3524,668,8937,Baja,72,2021-05-31,148,160,842,7299,9779,2480
1438,774,444,219,3916,636,8798,Baja,73,2021-05-31,171,176,1027,7774,9825,2051
2509,1434,1130,537,4675,906,15028,Media-Baja,74,2021-05-31,238,519,4917,11948,19945,7997
4201,2299,2235,855,6102,2875,29600,Media-Alta,75,2021-05-31,499,875,7457,19941,37057,17116
2811,1675,1043,481,4338,1127,15080,Media-Baja,76,2021-05-31,266,534,5289,12275,20369,8094
2698,1568,1036,537,5275,1484,14625,Media-Baja,77,2021-05-31,290,550,4191,13438,18816,5378
3529,3222,2294,960,6126,2483,29729,Media-Alta,79,2021-05-31,489,771,7388,19874,37117,17243
4077,2667,1800,1223,5065,2455,34261,Media-Alta,80,2021-05-31,388,854,8402,18529,42663,24134
2625,1623,1011,462,4738,1358,17245,Media-Baja,81,2021-05-31,267,475,4771,12559,22016,9457
1147,912,374,233,3674,542,9345,Baja,82,2021-05-31,156,144,1022,7182,10367,3185
1401,879,424,220,3060,574,8726,Baja,83,2021-05-31,144,136,905,6838,9631,2793
2613,1445,1089,516,4807,1383,14850,Media-Baja,84,2021-05-31,264,440,5115,12557,19965,7408
1248,785,458,204,3720,740,7952,Baja,85,2021-05-31,168,152,906,7475,8858,1383
1382,601,343,195,3947,718,8352,Baja,86,2021-05-31,134,179,867,7499,9219,1720
3115,1525,1011,517,4691,1400,13794,Media-Baja,87,2021-05-31,249,514,5075,13022,18869,5847
2418,1828,1031,458,5499,1305,14801,Media-Baja,88,2021-05-31,235,504,5704,13278,20505,7227
1182,916,330,212,3390,774,8566,Baja,89,2021-05-31,151,173,874,7128,9440,2312
1227,850,336,239,3517,594,7123,Baja,90,2021-05-31,147,132,677,7042,7800,758
2713,1284,1133,521,4850,1052,15013,Media-Baja,91,2021-05-31,283,579,4992,12415,20005,7590
3646,3031,2443,1236,5828,2713,32098,Media-Alta,92,2021-05-31,535,846,8002,20278,40100,19822
2661,1751,1067,593,5832,1291,15407,Media-Baja,93,2021-05-31,269,482,5007,13946,20414,6468
2543,1592,1205,562,4708,1380,14248,Media-Baja,94,2021-05-31,269,529,4710,12788,18958,6170
3387,1513,1048,572,4847,1557,18280,Media-Baja,95,2021-05-31,214,558,4983,13696,23263,9567
1447,815,381,238,4107,702,8531,Baja,96,2021-05-31,166,152,711,8008,9242,1234
2731,1596,1192,449,3892,1284,14892,Media-Baja,97,2021-05-31,232,661,5921,12037,20813,8776
1215,744,361,184,3250,589,8999,Baja,98,2021-05-31,172,170,980,6685,9979,3294
2800,1486,1010,520,4983,1310,15614,Media-Baja,99,2021-05-31,281,561,6007,12951,21621,8670
3938,2823,1912,1062,6030,2502,25359,Media-Alta,0,2021-06-30,558,811,8704,19636,34063,14427
1177,850,407,178,3681,599,7369,Baja,1,2021-06-30,153,175,875,7220,8244,1024
2762,1367,874,549,4999,1222,14472,Media-Baja,2,2021-06-30,295,580,5509,12648,19981,7333
4218,2637,2255,1067,4744,2997,32933,Media-Alta,3,2021-06-30,532,768,8242,19218,41175,21957
1353,832,315,177,3263,602,10001,Baja,4,2021-06-30,165,164,915,6871,10916,4045
2742,1703,1077,501,4275,1281,15266,Media-Baja,5,2021-06-30,233,483,5463,12295,20729,8434
2463,1537,948,460,4937,1662,15962,Media-Baja,6,2021-06-30,255,447,4786,12709,20748,8039
4566,3971,2975,2247,8661,4616,85505,Alta,7,2021-06-30,4592,4084,16796,35712,102301,66589
4313,2617,2576,1113,7631,2710,32806,Media-Alta,8,2021-06-30,642,655,8471,22257,41277,19020
4562,3289,3268,2041,8368,4501,78258,Alta,9,2021-06-30,4935,5176,18051,36140,96309,60169
2656,1474,1217,595,5264,1342,17341,Media-Baja,10,2021-06-30,300,525,4932,13373,22273,8900
2320,1591,1205,493,5107,1366,14769,Media-Baja,11,2021-06-30,275,431,4445,12788,19214,6426
2923,1598,1077,613,5352,1400,16037,Media-Baja,12,2021-06-30,280,505,4295,13748,20332,6584
3962,3452,2242,1040,5499,2692,34648,Media-Alta,13,2021-06-30,542,705,7717,20134,42365,22231
2758,1620,964,483,5443,1331,13798,Media-Baja,14,2021-06-30,225,473,3898,13297,17696,4399
1387,598,400,201,4083,640,7498,Baja,15,2021-06-30,180,133,903,7622,8401,779
2419,1539,1132,595,5454,1373,14536,Media-Baja,16,2021-06-30,274,493,4926,13279,19462,6183
2757,1632,956,549,4540,1163,15721,Media-Baja,17,2021-06-30,249,562,6118,12408,21839,9431
2968,1439,904,472,4277,1124,17686,Media-Baja,18,2021-06-30,321,547,4854,12052,22540,10488
2870,1481,997,519,5495,1330,15661,Media-Baja,19,2021-06-30,317,426,4407,13435,20068,6633
2569,1418,866,534,4700,1306,17834,Media-Baja,20,2021-06-30,278,482,5445,12153,23279,11126
3773,2857,2062,1198,5716,2976,29428,Media-Alta,21,2021-06-30,530,939,7480,20051,36908,16857
4671,3760,2101,981,4895,3309,35835,Media-Alta,22,2021-06-30,568,694,6839,20979,42674,21695
2349,1422,1080,517,4728,1652,17283,Media-Baja,23,2021-06-30,213,530,4403,12491,21686,9195
1422,839,378,172,3228,557,8645,Baja,24,2021-06-30,173,143,880,6912,9525,2613
5760,4674,3894,1650,9416,4934,63611,Alta,25,2021-06-30,4922,5447,17349,40697,80960,40263
4231,3154,2447,1216,5928,2747,28664,Media-Alta,26,2021-06-30,518,704,8009,20945,36673,15728
1434,819,367,228,3180,653,8211,Baja,27,2021-06-30,149,149,875,6979,9086,2107
4105,2896,2025,1008,5877,2812,39154,Media-Alta,28,2021-06-30,482,743,8102,19948,47256,27308
1208,719,362,229,3775,698,8956,Baja,29,2021-06-30,153,146,829,7290,9785,2495
2515,1481,1088,449,4106,1535,16394,Media-Baja,30,2021-06-30,261,591,4787,12026,21181,9155
3447,3674,2005,1161,6343,2584,29260,Media-Alta,31,2021-06-30,585,834,8600,20633,37860,17227
1510,843,374,239,3985,538,8152,Baja,32,2021-06-30,143,153,876,7785,9028,1243
5644,4590,3104,1778,9087,4464,62916,Alta,33,2021-06-30,4682,4757,17151,38106,80067,41961
2258,1619,1031,512,3481,1029,16992,Media-Baja,34,2021-06-30,230,540,5879,10700,22871,12171
2596,1738,1092,469,4689,1026,15532,Media-Baja,35,2021-06-30,257,520,5220,12387,20752,8365
2584,1573,851,567,3749,1280,15776,Media-Baja,36,2021-06-30,277,530,5030,11411,20806,9395
2574,1329,1096,605,4581,1325,16039,Media-Baja,37,2021-06-30,250,531,5542,12291,21581,9290
2235,1696,944,445,5230,1375,15525,Media-Baja,38,2021-06-30,287,477,5365,12689,20890,8201
6469,4438,3060,2021,8398,3940,78138,Alta,39,2021-06-30,5159,4868,17368,38353,95506,57153
4872,3264,3683,1755,9347,4370,73689,Alta,40,2021-06-30,5241,5283,16880,37815,90569,52754
5394,4188,3044,1983,10734,4194,70688,Alta,41,2021-06-30,5312,4459,15922,39308,86610,47302
4068,2632,2089,1223,5420,2404,31329,Media-Alta,42,2021-06-30,579,777,8797,19192,40126,20934
5719,4194,3214,1952,7794,3907,83368,Alta,43,2021-06-30,4954,4874,17716,36608,101084,64476
6560,4479,4072,1681,8863,4387,68702,Alta,44,2021-06-30,4930,5546,19110,40518,87812,47294
3560,2822,1859,925,6087,2668,31016,Media-Alta,45,2021-06-30,557,840,8034,19318,39050,19732
3701,2901,1918,1315,5504,2570,29089,Media-Alta,46,2021-06-30,493,772,7115,19174,36204,17030
2454,1544,1067,488,4398,1461,15571,Media-Baja,47,2021-06-30,240,547,4172,12199,19743,7544
2371,1468,1126,542,4135,1152,15088,Media-Baja,48,2021-06-30,271,581,4286,11646,19374,7728
2794,1790,826,422,5371,1557,16358,Media-Baja,49,2021-06-30,256,495,4723,13511,21081,7570
2757,1842,913,498,5188,1304,17385,Media-Baja,50,2021-06-30,292,529,5547,13323,22932,9609
1362,770,318,201,3490,598,9308,Baja,51,2021-06-30,135,149,933,7023,10241,3218
3869,3137,1949,889,5027,2617,34780,Media-Alta,52,2021-06-30,501,720,9155,18709,43935,25226
1350,877,350,183,3540,667,8648,Baja,53,2021-06-30,141,126,873,7234,9521,2287
4301,2797,2272,1134,7122,2251,31540,Media-Alta,54,2021-06-30,569,973,7076,21419,38616,17197
2674,1599,982,554,4062,1356,17288,Media-Baja,55,2021-06-30,269,439,4640,11935,21928,9993
1366,699,355,242,3669,630,8786,Baja,56,2021-06-30,145,139,863,7245,9649,2404
2642,1774,1078,447,4293,1034,15264,Media-Baja,57,2021-06-30,296,461,5169,12025,20433,8408
2437,1934,986,508,4766,1313,17038,Media-Baja,58,2021-06-30,258,542,4659,12744,21697,8953
3267,2609,2148,976,5103,2623,32994,Media-Alta,59,2021-06-30,485,885,8083,18096,41077,22981
2574,1528,1082,705,4757,1243,15421,Media-Baja,60,2021-06-30,302,464,4723,12655,20144,7489
2119,1599,1270,629,4631,1189,14745,Media-Baja,61,2021-06-30,252,504,5844,12193,20589,8396
3500,3109,2018,1132,5955,2431,27324,Media-Alta,62,2021-06-30,482,825,7135,19452,34459,15007
2619,1633,1098,536,5503,1370,14914,Media-Baja,63,2021-06-30,287,550,5230,13596,20144,6548
3811,2759,1797,946,5372,2835,25283,Media-Alta,64,2021-06-30,448,764,8943,18732,34226,15494
4831,2950,2476,998,7017,2081,32381,Media-Alta,65,2021-06-30,615,851,8250,21819,40631,18812
3528,3125,2062,1045,5080,2916,32663,Media-Alta,66,2021-06-30,477,822,8305,19055,40968,21913
4468,3298,2329,1094,6458,2392,29526,Media-Alta,67,2021-06-30,506,811,9151,21356,38677,17321
1275,751,349,213,4145,668,9537,Baja,69,2021-06-30,178,176,835,7755,10372,2617
2605,1808,1173,523,4418,1480,13851,Media-Baja,70,2021-06-30,221,655,5432,12883,19283,6400
5383,4079,3325,2073,8012,3521,66571,Alta,71,2021-06-30,5467,5418,15681,37278,82252,44974
1322,910,350,217,3524,668,8937,Baja,72,2021-06-30,193,144,735,7328,9672,2344
1438,774,444,219,3916,636,8798,Baja,73,2021-06-30,147,144,907,7718,9705,1987
2509,1434,1130,537,4675,906,15028,Media-Baja,74,2021-06-30,257,550,4133,11998,19161,7163
4201,2299,2235,855,6102,2875,29600,Media-Alta,75,2021-06-30,542,794,8580,19903,38180,18277
2811,1675,1043,481,4338,1127,15080,Media-Baja,76,2021-06-30,267,544,5507,12286,20587,8301
2698,1568,1036,537,5275,1484,14625,Media-Baja,77,2021-06-30,229,482,4589,13309,19214,5905
3529,3222,2294,960,6126,2483,29729,Media-Alta,79,2021-06-30,520,849,6765,19983,36494,16511
4077,2667,1800,1223,5065,2455,34261,Media-Alta,80,2021-06-30,475,778,8096,18540,42357,23817
2625,1623,1011,462,4738,1358,17245,Media-Baja,81,2021-06-30,237,569,4930,12623,22175,9552
1147,912,374,233,3674,542,9345,Baja,82,2021-06-30,126,155,824,7163,10169,3006
1401,879,424,220,3060,574,8726,Baja,83,2021-06-30,161,155,868,6874,9594,2720
2613,1445,1089,516,4807,1383,14850,Media-Baja,84,2021-06-30,242,488,5730,12583,20580,7997
1248,785,458,204,3720,740,7952,Baja,85,2021-06-30,129,148,918,7432,8870,1438
1382,601,343,195,3947,718,8352,Baja,86,2021-06-30,177,186,802,7549,9154,1605
3115,1525,1011,517,4691,1400,13794,Media-Baja,87,2021-06-30,281,602,5326,13142,19120,5978
2418,1828,1031,458,5499,1305,14801,Media-Baja,88,2021-06-30,272,495,4291,13306,19092,5786
1182,916,330,212,3390,774,8566,Baja,89,2021-06-30,154,138,929,7096,9495,2399
1227,850,336,239,3517,594,7123,Baja,90,2021-06-30,158,170,788,7091,7911,820
2713,1284,1133,521,4850,1052,15013,Media-Baja,91,2021-06-30,287,556,5025,12396,20038,7642
3646,3031,2443,1236,5828,2713,32098,Media-Alta,92,2021-06-30,504,790,7105,20191,39203,19012
2661,1751,1067,593,5832,1291,15407,Media-Baja,93,2021-06-30,283,432,5637,13910,21044,7134
2543,1592,1205,562,4708,1380,14248,Media-Baja,94,2021-06-30,224,405,4450,12619,18698,6079
3387,1513,1048,572,4847,1557,18280,Media-Baja,95,2021-06-30,312,579,5246,13815,23526,9711
1447,815,381,238,4107,702,8531,Baja,96,2021-06-30,159,134,813,7983,9344,1361
2731,1596,1192,449,3892,1284,14892,Media-Baja,97,2021-06-30,268,455,4509,11867,19401,7534
1215,744,361,184,3250,589,8999,Baja,98,2021-06-30,158,143,908,6644,9907,3263
2800,1486,1010,520,4983,1310,15614,Media-Baja,99,2021-06-30,243,520,5313,12872,20927,8055
3938,2823,1912,1062,6030,2502,25359,Media-Alta,0,2021-07-31,438,694,9573,19399,34932,15533
1177,850,407,178,3681,599,7369,Baja,1,2021-07-31,155,137,754,7184,8123,939
2762,1367,874,549,4999,1222,14472,Media-Baja,2,2021-07-31,243,526,5283,12542,19755,7213
4218,2637,2255,1067,4744,2997,32933,Media-Alta,3,2021-07-31,554,900,7948,19372,40881,21509
1353,832,315,177,3263,602,10001,Baja,4,2021-07-31,152,196,788,6890,10789,3899
2742,1703,1077,501,4275,1281,15266,Media-Baja,5,2021-07-31,248,541,4795,12368,20061,7693
2463,1537,948,460,4937,1662,15962,Media-Baja,6,2021-07-31,261,598,5141,12866,21103,8237
4566,3971,2975,2247,8661,4616,85505,Alta,7,2021-07-31,5526,4589,18963,37151,104468,67317
4313,2617,2576,1113,7631,2710,32806,Media-Alta,8,2021-07-31,502,708,9321,22170,42127,19957
4562,3289,3268,2041,8368,4501,78258,Alta,9,2021-07-31,4623,4422,16813,35074,95071,59997
2656,1474,1217,595,5264,1342,17341,Media-Baja,10,2021-07-31,305,531,5551,13384,22892,9508
2320,1591,1205,493,5107,1366,14769,Media-Baja,11,2021-07-31,278,533,4642,12893,19411,6518
2923,1598,1077,613,5352,1400,16037,Media-Baja,12,2021-07-31,277,530,4734,13770,20771,7001
3962,3452,2242,1040,5499,2692,34648,Media-Alta,13,2021-07-31,482,741,7746,20110,42394,22284
2758,1620,964,483,5443,1331,13798,Media-Baja,14,2021-07-31,253,480,4975,13332,18773,5441
1387,598,400,201,4083,640,7498,Baja,15,2021-07-31,141,175,745,7625,8243,618
2419,1539,1132,595,5454,1373,14536,Media-Baja,16,2021-07-31,232,512,4966,13256,19502,6246
2757,1632,956,549,4540,1163,15721,Media-Baja,17,2021-07-31,247,505,4748,12349,20469,8120
2968,1439,904,472,4277,1124,17686,Media-Baja,18,2021-07-31,277,586,5325,12047,23011,10964
2870,1481,997,519,5495,1330,15661,Media-Baja,19,2021-07-31,281,640,5137,13613,20798,7185
2569,1418,866,534,4700,1306,17834,Media-Baja,20,2021-07-31,272,487,5050,12152,22884,10732
3773,2857,2062,1198,5716,2976,29428,Media-Alta,21,2021-07-31,559,880,8924,20021,38352,18331
4671,3760,2101,981,4895,3309,35835,Media-Alta,22,2021-07-31,531,784,9005,21032,44840,23808
2349,1422,1080,517,4728,1652,17283,Media-Baja,23,2021-07-31,300,448,4612,12496,21895,9399
1422,839,378,172,3228,557,8645,Baja,24,2021-07-31,141,163,920,6900,9565,2665
5760,4674,3894,1650,9416,4934,63611,Alta,25,2021-07-31,4758,4214,15044,39300,78655,39355
4231,3154,2447,1216,5928,2747,28664,Media-Alta,26,2021-07-31,386,838,8305,20947,36969,16022
1434,819,367,228,3180,653,8211,Baja,27,2021-07-31,151,143,889,6975,9100,2125
4105,2896,2025,1008,5877,2812,39154,Media-Alta,28,2021-07-31,430,715,6852,19868,46006,26138
1208,719,362,229,3775,698,8956,Baja,29,2021-07-31,147,136,956,7274,9912,2638
2515,1481,1088,449,4106,1535,16394,Media-Baja,30,2021-07-31,265,501,4853,11940,21247,9307
3447,3674,2005,1161,6343,2584,29260,Media-Alta,31,2021-07-31,525,890,8144,20629,37404,16775
1510,843,374,239,3985,538,8152,Baja,32,2021-07-31,154,171,942,7814,9094,1280
5644,4590,3104,1778,9087,4464,62916,Alta,33,2021-07-31,4736,4232,19402,37635,82318,44683
2258,1619,1031,512,3481,1029,16992,Media-Baja,34,2021-07-31,254,462,5375,10646,22367,11721
2596,1738,1092,469,4689,1026,15532,Media-Baja,35,2021-07-31,273,450,5434,12333,20966,8633
2584,1573,851,567,3749,1280,15776,Media-Baja,36,2021-07-31,275,504,5397,11383,21173,9790
2574,1329,1096,605,4581,1325,16039,Media-Baja,37,2021-07-31,277,552,5056,12339,21095,8756
2235,1696,944,445,5230,1375,15525,Media-Baja,38,2021-07-31,227,525,4480,12677,20005,7328
6469,4438,3060,2021,8398,3940,78138,Alta,39,2021-07-31,4473,4616,17508,37415,95646,58231
4872,3264,3683,1755,9347,4370,73689,Alta,40,2021-07-31,5277,4886,16227,37454,89916,52462
5394,4188,3044,1983,10734,4194,70688,Alta,41,2021-07-31,4640,3768,16926,37945,87614,49669
4068,2632,2089,1223,5420,2404,31329,Media-Alta,42,2021-07-31,599,822,7802,19257,39131,19874
5719,4194,3214,1952,7794,3907,83368,Alta,43,2021-07-31,5434,5122,17463,37336,100831,63495
6560,4479,4072,1681,8863,4387,68702,Alta,44,2021-07-31,4936,4626,17571,39604,86273,46669
3560,2822,1859,925,6087,2668,31016,Media-Alta,45,2021-07-31,388,742,8728,19051,39744,20693
3701,2901,1918,1315,5504,2570,29089,Media-Alta,46,2021-07-31,507,858,7827,19274,36916,17642
2454,1544,1067,488,4398,1461,15571,Media-Baja,47,2021-07-31,262,577,5252,12251,20823,8572
2371,1468,1126,542,4135,1152,15088,Media-Baja,48,2021-07-31,276,511,5051,11581,20139,8558
2794,1790,826,422,5371,1557,16358,Media-Baja,49,2021-07-31,257,551,4318,13568,20676,7108
2757,1842,913,498,5188,1304,17385,Media-Baja,50,2021-07-31,266,596,5851,13364,23236,9872
1362,770,318,201,3490,598,9308,Baja,51,2021-07-31,139,145,777,7023,10085,3062
3869,3137,1949,889,5027,2617,34780,Media-Alta,52,2021-07-31,523,913,7803,18924,42583,23659
1350,877,350,183,3540,667,8648,Baja,53,2021-07-31,143,149,734,7259,9382,2123
4301,2797,2272,1134,7122,2251,31540,Media-Alta,54,2021-07-31,610,809,7078,21296,38618,17322
2674,1599,982,554,4062,1356,17288,Media-Baja,55,2021-07-31,227,530,4753,11984,22041,10057
1366,699,355,242,3669,630,8786,Baja,56,2021-07-31,148,141,817,7250,9603,2353
2642,1774,1078,447,4293,1034,15264,Media-Baja,57,2021-07-31,259,529,4582,12056,19846,7790
2437,1934,986,508,4766,1313,17038,Media-Baja,58,2021-07-31,246,555,4405,12745,21443,8698
3267,2609,2148,976,5103,2623,32994,Media-Alta,59,2021-07-31,568,842,8500,18136,41494,23358
2574,1528,1082,705,4757,1243,15421,Media-Baja,60,2021-07-31,236,463,4634,12588,20055,7467
2119,1599,1270,629,4631,1189,14745,Media-Baja,61,2021-07-31,298,512,5036,12247,19781,7534
3500,3109,2018,1132,5955,2431,27324,Media-Alta,62,2021-07-31,493,744,8359,19382,35683,16301
2619,1633,1098,536,5503,1370,14914,Media-Baja,63,2021-07-31,287,480,4754,13526,19668,6142
3811,2759,1797,946,5372,2835,25283,Media-Alta,64,2021-07-31,672,852,6392,19044,31675,12631
4831,2950,2476,998,7017,2081,32381,Media-Alta,65,2021-07-31,432,801,7669,21586,40050,18464
3528,3125,2062,1045,5080,2916,32663,Media-Alta,66,2021-07-31,498,783,9016,19037,41679,22642
4468,3298,2329,1094,6458,2392,29526,Media-Alta,67,2021-07-31,636,772,8812,21447,38338,16891
1275,751,349,213,4145,668,9537,Baja,69,2021-07-31,155,180,774,7736,10311,2575
2605,1808,1173,523,4418,1480,13851,Media-Baja,70,2021-07-31,276,451,5256,12734,19107,6373
5383,4079,3325,2073,8012,3521,66571,Alta,71,2021-07-31,5534,5006,17662,36933,84233,47300
1322,910,350,217,3524,668,8937,Baja,72,2021-07-31,166,152,735,7309,9672,2363
1438,774,444,219,3916,636,8798,Baja,73,2021-07-31,186,158,727,7771,9525,1754
2509,1434,1130,537,4675,906,15028,Media-Baja,74,2021-07-31,257,463,4297,11911,19325,7414
4201,2299,2235,855,6102,2875,29600,Media-Alta,75,2021-07-31,539,783,8841,19889,38441,18552
2811,1675,1043,481,4338,1127,15080,Media-Baja,76,2021-07-31,257,580,4506,12312,19586,7274
2698,1568,1036,537,5275,1484,14625,Media-Baja,77,2021-07-31,240,492,5834,13330,20459,7129
3529,3222,2294,960,6126,2483,29729,Media-Alta,79,2021-07-31,535,713,8945,19862,38674,18812
4077,2667,1800,1223,5065,2455,34261,Media-Alta,80,2021-07-31,450,807,7830,18544,42091,23547
2625,1623,1011,462,4738,1358,17245,Media-Baja,81,2021-07-31,268,528,4967,12613,22212,9599
1147,912,374,233,3674,542,9345,Baja,82,2021-07-31,162,118,812,7162,10157,2995
1401,879,424,220,3060,574,8726,Baja,83,2021-07-31,168,163,809,6889,9535,2646
2613,1445,1089,516,4807,1383,14850,Media-Baja,84,2021-07-31,237,512,4439,12602,19289,6687
1248,785,458,204,3720,740,7952,Baja,85,2021-07-31,154,149,832,7458,8784,1326
1382,601,343,195,3947,718,8352,Baja,86,2021-07-31,173,172,835,7531,9187,1656
3115,1525,1011,517,4691,1400,13794,Media-Baja,87,2021-07-31,311,688,5182,13258,18976,5718
2418,1828,1031,458,5499,1305,14801,Media-Baja,88,2021-07-31,256,508,5047,13303,19848,6545
1182,916,330,212,3390,774,8566,Baja,89,2021-07-31,180,146,974,7130,9540,2410
1227,850,336,239,3517,594,7123,Baja,90,2021-07-31,162,135,850,7060,7973,913
2713,1284,1133,521,4850,1052,15013,Media-Baja,91,2021-07-31,278,512,4135,12343,19148,6805
3646,3031,2443,1236,5828,2713,32098,Media-Alta,92,2021-07-31,646,685,7560,20228,39658,19430
2661,1751,1067,593,5832,1291,15407,Media-Baja,93,2021-07-31,240,499,5074,13934,20481,6547
2543,1592,1205,562,4708,1380,14248,Media-Baja,94,2021-07-31,219,502,6008,12711,20256,7545
3387,1513,1048,572,4847,1557,18280,Media-Baja,95,2021-07-31,253,486,5785,13663,24065,10402
1447,815,381,238,4107,702,8531,Baja,96,2021-07-31,161,143,844,7994,9375,1381
2731,1596,1192,449,3892,1284,14892,Media-Baja,97,2021-07-31,256,477,4998,11877,19890,8013
1215,744,361,184,3250,589,8999,Baja,98,2021-07-31,171,163,917,6677,9916,3239
2800,1486,1010,520,4983,1310,15614,Media-Baja,99,2021-07-31,300,658,4702,13067,20316,7249
3938,2823,1912,1062,6030,2502,25359,Media-Alta,0,2021-08-31,597,695,7715,19559,33074,13515
1177,850,407,178,3681,599,7369,Baja,1,2021-08-31,158,176,945,7226,8314,1088
2762,1367,874,549,4999,1222,14472,Media-Baja,2,2021-08-31,209,572,5182,12554,19654,7100
4218,2637,2255,1067,4744,2997,32933,Media-Alta,3,2021-08-31,549,743,7923,19210,40856,21646
1353,832,315,177,3263,602,10001,Baja,4,2021-08-31,147,159,990,6848,10991,4143
2742,1703,1077,501,4275,1281,15266,Media-Baja,5,2021-08-31,253,525,4579,12357,19845,7488
2463,1537,948,460,4937,1662,15962,Media-Baja,6,2021-08-31,269,623,4337,12899,20299,7400
4566,3971,2975,2247,8661,4616,85505,Alta,7,2021-08-31,5161,4822,17531,37019,103036,66017
4313,2617,2576,1113,7631,2710,32806,Media-Alta,8,2021-08-31,526,939,9314,22425,42120,19695
4562,3289,3268,2041,8368,4501,78258,Alta,9,2021-08-31,4874,5722,17669,36625,95927,59302
2656,1474,1217,595,5264,1342,17341,Media-Baja,10,2021-08-31,255,547,5645,13350,22986,9636
2320,1591,1205,493,5107,1366,14769,Media-Baja,11,2021-08-31,206,508,4242,12796,19011,6215
2923,1598,1077,613,5352,1400,16037,Media-Baja,12,2021-08-31,241,618,4870,13822,20907,7085
3962,3452,2242,1040,5499,2692,34648,Media-Alta,13,2021-08-31,518,737,7035,20142,41683,21541
2758,1620,964,483,5443,1331,13798,Media-Baja,14,2021-08-31,251,550,3805,13400,17603,4203
1387,598,400,201,4083,640,7498,Baja,15,2021-08-31,162,164,878,7635,8376,741
2419,1539,1132,595,5454,1373,14536,Media-Baja,16,2021-08-31,284,505,4800,13301,19336,6035
2757,1632,956,549,4540,1163,15721,Media-Baja,17,2021-08-31,198,461,4291,12256,20012,7756
2968,1439,904,472,4277,1124,17686,Media-Baja,18,2021-08-31,261,496,4483,11941,22169,10228
2870,1481,997,519,5495,1330,15661,Media-Baja,19,2021-08-31,291,522,5331,13505,20992,7487
2569,1418,866,534,4700,1306,17834,Media-Baja,20,2021-08-31,268,442,4799,12103,22633,10530
3773,2857,2062,1198,5716,2976,29428,Media-Alta,21,2021-08-31,537,798,8022,19917,37450,17533
4671,3760,2101,981,4895,3309,35835,Media-Alta,22,2021-08-31,469,753,8028,20939,43863,22924
2349,1422,1080,517,4728,1652,17283,Media-Baja,23,2021-08-31,297,512,4233,12557,21516,8959
1422,839,378,172,3228,557,8645,Baja,24,2021-08-31,142,151,852,6889,9497,2608
5760,4674,3894,1650,9416,4934,63611,Alta,25,2021-08-31,5625,4861,17915,40814,81526,40712
4231,3154,2447,1216,5928,2747,28664,Media-Alta,26,2021-08-31,470,802,7385,20995,36049,15054
1434,819,367,228,3180,653,8211,Baja,27,2021-08-31,166,181,890,7028,9101,2073
4105,2896,2025,1008,5877,2812,39154,Media-Alta,28,2021-08-31,465,723,8723,19911,47877,27966
1208,719,362,229,3775,698,8956,Baja,29,2021-08-31,143,156,651,7290,9607,2317
2515,1481,1088,449,4106,1535,16394,Media-Baja,30,2021-08-31,248,539,4939,11961,21333,9372
3447,3674,2005,1161,6343,2584,29260,Media-Alta,31,2021-08-31,644,821,8359,20679,37619,16940
1510,843,374,239,3985,538,8152,Baja,32,2021-08-31,182,158,789,7829,8941,1112
5644,4590,3104,1778,9087,4464,62916,Alta,33,2021-08-31,5564,4749,16417,38980,79333,40353
2258,1619,1031,512,3481,1029,16992,Media-Baja,34,2021-08-31,279,539,4426,10748,21418,10670
2596,1738,1092,469,4689,1026,15532,Media-Baja,35,2021-08-31,277,556,5115,12443,20647,8204
2584,1573,851,567,3749,1280,15776,Media-Baja,36,2021-08-31,259,570,4737,11433,20513,9080
2574,1329,1096,605,4581,1325,16039,Media-Baja,37,2021-08-31,276,522,5502,12308,21541,9233
2235,1696,944,445,5230,1375,15525,Media-Baja,38,2021-08-31,269,563,5310,12757,20835,8078
6469,4438,3060,2021,8398,3940,78138,Alta,39,2021-08-31,5513,5014,16946,38853,95084,56231
4872,3264,3683,1755,9347,4370,73689,Alta,40,2021-08-31,5607,4893,13854,37791,87543,49752
5394,4188,3044,1983,10734,4194,70688,Alta,41,2021-08-31,5462,4426,15668,39425,86356,46931
4068,2632,2089,1223,5420,2404,31329,Media-Alta,42,2021-08-31,553,785,8114,19174,39443,20269
5719,4194,3214,1952,7794,3907,83368,Alta,43,2021-08-31,4847,4893,16482,36520,99850,63330
6560,4479,4072,1681,8863,4387,68702,Alta,44,2021-08-31,5318,4760,14858,40120,83560,43440
3560,2822,1859,925,6087,2668,31016,Media-Alta,45,2021-08-31,493,820,7359,19234,38375,19141
3701,2901,1918,1315,5504,2570,29089,Media-Alta,46,2021-08-31,543,666,8190,19118,37279,18161
2454,1544,1067,488,4398,1461,15571,Media-Baja,47,2021-08-31,289,575,4885,12276,20456,8180
2371,1468,1126,542,4135,1152,15088,Media-Baja,48,2021-08-31,268,533,5237,11595,20325,8730
2794,1790,826,422,5371,1557,16358,Media-Baja,49,2021-08-31,257,665,5045,13682,21403,7721
2757,1842,913,498,5188,1304,17385,Media-Baja,50,2021-08-31,267,473,4838,13242,22223,8981
1362,770,318,201,3490,598,9308,Baja,51,2021-08-31,157,164,997,7060,10305,3245
3869,3137,1949,889,5027,2617,34780,Media-Alta,52,2021-08-31,559,974,9542,19021,44322,25301
1350,877,350,183,3540,667,8648,Baja,53,2021-08-31,162,155,810,7284,9458,2174
4301,2797,2272,1134,7122,2251,31540,Media-Alta,54,2021-08-31,486,884,8415,21247,39955,18708
2674,1599,982,554,4062,1356,17288,Media-Baja,55,2021-08-31,241,434,4761,11902,22049,10147
1366,699,355,242,3669,630,8786,Baja,56,2021-08-31,156,139,889,7256,9675,2419
2642,1774,1078,447,4293,1034,15264,Media-Baja,57,2021-08-31,234,572,5451,12074,20715,8641
2437,1934,986,508,4766,1313,17038,Media-Baja,58,2021-08-31,275,428,4581,12647,21619,8972
3267,2609,2148,976,5103,2623,32994,Media-Alta,59,2021-08-31,552,896,7730,18174,40724,22550
2574,1528,1082,705,4757,1243,15421,Media-Baja,60,2021-08-31,225,418,5251,12532,20672,8140
2119,1599,1270,629,4631,1189,14745,Media-Baja,61,2021-08-31,203,366,4749,12006,19494,7488
3500,3109,2018,1132,5955,2431,27324,Media-Alta,62,2021-08-31,554,608,6539,19307,33863,14556
2619,1633,1098,536,5503,1370,14914,Media-Baja,63,2021-08-31,219,522,5580,13500,20494,6994
3811,2759,1797,946,5372,2835,25283,Media-Alta,64,2021-08-31,466,815,8185,18801,33468,14667
4831,2950,2476,998,7017,2081,32381,Media-Alta,65,2021-08-31,457,724,8454,21534,40835,19301
3528,3125,2062,1045,5080,2916,32663,Media-Alta,66,2021-08-31,514,794,7387,19064,40050,20986
4468,3298,2329,1094,6458,2392,29526,Media-Alta,67,2021-08-31,569,774,7496,21382,37022,15640
1275,751,349,213,4145,668,9537,Baja,69,2021-08-31,168,154,932,7723,10469,2746
2605,1808,1173,523,4418,1480,13851,Media-Baja,70,2021-08-31,265,636,4565,12908,18416,5508
5383,4079,3325,2073,8012,3521,66571,Alta,71,2021-08-31,5437,3918,17077,35748,83648,47900
1322,910,350,217,3524,668,8937,Baja,72,2021-08-31,173,166,818,7330,9755,2425
1438,774,444,219,3916,636,8798,Baja,73,2021-08-31,158,160,672,7745,9470,1725
2509,1434,1130,537,4675,906,15028,Media-Baja,74,2021-08-31,236,533,4486,11960,19514,7554
4201,2299,2235,855,6102,2875,29600,Media-Alta,75,2021-08-31,564,722,7420,19853,37020,17167
2811,1675,1043,481,4338,1127,15080,Media-Baja,76,2021-08-31,255,543,4955,12273,20035,7762
2698,1568,1036,537,5275,1484,14625,Media-Baja,77,2021-08-31,280,486,5194,13364,19819,6455
3529,3222,2294,960,6126,2483,29729,Media-Alta,79,2021-08-31,448,855,8566,19917,38295,18378
4077,2667,1800,1223,5065,2455,34261,Media-Alta,80,2021-08-31,611,776,8626,18674,42887,24213
2625,1623,1011,462,4738,1358,17245,Media-Baja,81,2021-08-31,272,445,4932,12534,22177,9643
1147,912,374,233,3674,542,9345,Baja,82,2021-08-31,175,165,727,7222,10072,2850
1401,879,424,220,3060,574,8726,Baja,83,2021-08-31,164,153,857,6875,9583,2708
2613,1445,1089,516,4807,1383,14850,Media-Baja,84,2021-08-31,224,609,5264,12686,20114,7428
1248,785,458,204,3720,740,7952,Baja,85,2021-08-31,159,163,789,7477,8741,1264
1382,601,343,195,3947,718,8352,Baja,86,2021-08-31,135,165,913,7486,9265,1779
3115,1525,1011,517,4691,1400,13794,Media-Baja,87,2021-08-31,323,463,5089,13045,18883,5838
2418,1828,1031,458,5499,1305,14801,Media-Baja,88,2021-08-31,295,511,5170,13345,19971,6626
1182,916,330,212,3390,774,8566,Baja,89,2021-08-31,163,171,816,7138,9382,2244
1227,850,336,239,3517,594,7123,Baja,90,2021-08-31,162,163,732,7088,7855,767
2713,1284,1133,521,4850,1052,15013,Media-Baja,91,2021-08-31,273,550,4446,12376,19459,7083
3646,3031,2443,1236,5828,2713,32098,Media-Alta,92,2021-08-31,487,698,9443,20082,41541,21459
2661,1751,1067,593,5832,1291,15407,Media-Baja,93,2021-08-31,243,592,5553,14030,20960,6930
2543,1592,1205,562,4708,1380,14248,Media-Baja,94,2021-08-31,264,507,5566,12761,19814,7053
3387,1513,1048,572,4847,1557,18280,Media-Baja,95,2021-08-31,248,557,5811,13729,24091,10362
1447,815,381,238,4107,702,8531,Baja,96,2021-08-31,153,138,820,7981,9351,1370
2731,1596,1192,449,3892,1284,14892,Media-Baja,97,2021-08-31,240,547,4489,11931,19381,7450
1215,744,361,184,3250,589,8999,Baja,98,2021-08-31,160,157,767,6660,9766,3106
2800,1486,1010,520,4983,1310,15614,Media-Baja,99,2021-08-31,250,505,4904,12864,20518,7654
3938,2823,1912,1062,6030,2502,25359,Media-Alta,0,2021-09-30,627,878,7777,19772,33136,13364
1177,850,407,178,3681,599,7369,Baja,1,2021-09-30,135,196,906,7223,8275,1052
2762,1367,874,549,4999,1222,14472,Media-Baja,2,2021-09-30,249,555,5785,12577,20257,7680
4218,2637,2255,1067,4744,2997,32933,Media-Alta,3,2021-09-30,596,694,6828,19208,39761,20553
1353,832,315,177,3263,602,10001,Baja,4,2021-09-30,129,173,699,6844,10700,3856
2742,1703,1077,501,4275,1281,15266,Media-Baja,5,2021-09-30,201,585,5454,12365,20720,8355
2463,1537,948,460,4937,1662,15962,Media-Baja,6,2021-09-30,271,522,5226,12800,21188,8388
4566,3971,2975,2247,8661,4616,85505,Alta,7,2021-09-30,5103,4655,16294,36794,101799,65005
4313,2617,2576,1113,7631,2710,32806,Media-Alta,8,2021-09-30,551,825,7745,22336,40551,18215
4562,3289,3268,2041,8368,4501,78258,Alta,9,2021-09-30,5810,4572,18450,36411,96708,60297
2656,1474,1217,595,5264,1342,17341,Media-Baja,10,2021-09-30,257,468,5430,13273,22771,9498
2320,1591,1205,493,5107,1366,14769,Media-Baja,11,2021-09-30,210,588,3835,12880,18604,5724
2923,1598,1077,613,5352,1400,16037,Media-Baja,12,2021-09-30,249,457,5300,13669,21337,7668
3962,3452,2242,1040,5499,2692,34648,Media-Alta,13,2021-09-30,575,869,8536,20331,43184,22853
2758,1620,964,483,5443,1331,13798,Media-Baja,14,2021-09-30,223,592,5039,13414,18837,5423
1387,598,400,201,4083,640,7498,Baja,15,2021-09-30,160,170,968,7639,8466,827
2419,1539,1132,595,5454,1373,14536,Media-Baja,16,2021-09-30,289,536,4909,13337,19445,6108
2757,1632,956,549,4540,1163,15721,Media-Baja,17,2021-09-30,258,530,4260,12385,19981,7596
2968,1439,904,472,4277,1124,17686,Media-Baja,18,2021-09-30,277,530,4946,11991,22632,10641
2870,1481,997,519,5495,1330,15661,Media-Baja,19,2021-09-30,242,553,5426,13487,21087,7600
2569,1418,866,534,4700,1306,17834,Media-Baja,20,2021-09-30,259,579,4636,12231,22470,10239
3773,2857,2062,1198,5716,2976,29428,Media-Alta,21,2021-09-30,532,801,7757,19915,37185,17270
4671,3760,2101,981,4895,3309,35835,Media-Alta,22,2021-09-30,581,693,7849,20991,43684,22693
2349,1422,1080,517,4728,1652,17283,Media-Baja,23,2021-09-30,256,550,3761,12554,21044,8490
1422,839,378,172,3228,557,8645,Baja,24,2021-09-30,138,153,759,6887,9404,2517
5760,4674,3894,1650,9416,4934,63611,Alta,25,2021-09-30,5699,5370,17977,41397,81588,40191
4231,3154,2447,1216,5928,2747,28664,Media-Alta,26,2021-09-30,507,861,7844,21091,36508,15417
1434,819,367,228,3180,653,8211,Baja,27,2021-09-30,173,178,857,7032,9068,2036
4105,2896,2025,1008,5877,2812,39154,Media-Alta,28,2021-09-30,518,863,7903,20104,47057,26953
1208,719,362,229,3775,698,8956,Baja,29,2021-09-30,182,156,767,7329,9723,2394
2515,1481,1088,449,4106,1535,16394,Media-Baja,30,2021-09-30,295,542,4643,12011,21037,9026
3447,3674,2005,1161,6343,2584,29260,Media-Alta,31,2021-09-30,570,834,8180,20618,37440,16822
1510,843,374,239,3985,538,8152,Baja,32,2021-09-30,163,142,810,7794,8962,1168
5644,4590,3104,1778,9087,4464,62916,Alta,33,2021-09-30,5459,4810,15855,38936,78771,39835
2258,1619,1031,512,3481,1029,16992,Media-Baja,34,2021-09-30,313,571,5397,10814,22389,11575
2596,1738,1092,469,4689,1026,15532,Media-Baja,35,2021-09-30,279,536,4909,12425,20441,8016
2584,1573,851,567,3749,1280,15776,Media-Baja,36,2021-09-30,281,582,4479,11467,20255,8788
2574,1329,1096,605,4581,1325,16039,Media-Baja,37,2021-09-30,256,564,5243,12330,21282,8952
2235,1696,944,445,5230,1375,15525,Media-Baja,38,2021-09-30,289,532,5346,12746,20871,8125
6469,4438,3060,2021,8398,3940,78138,Alta,39,2021-09-30,6183,4654,17164,39163,95302,56139
4872,3264,3683,1755,9347,4370,73689,Alta,40,2021-09-30,4824,4220,18412,36335,92101,55766
5394,4188,3044,1983,10734,4194,70688,Alta,41,2021-09-30,4551,4913,16088,39001,86776,47775
4068,2632,2089,1223,5420,2404,31329,Media-Alta,42,2021-09-30,554,732,7537,19122,38866,19744
5719,4194,3214,1952,7794,3907,83368,Alta,43,2021-09-30,5340,5070,19131,37190,102499,65309
6560,4479,4072,1681,8863,4387,68702,Alta,44,2021-09-30,4559,4773,15986,39374,84688,45314
3560,2822,1859,925,6087,2668,31016,Media-Alta,45,2021-09-30,567,873,8410,19361,39426,20065
3701,2901,1918,1315,5504,2570,29089,Media-Alta,46,2021-09-30,476,781,9625,19166,38714,19548
2454,1544,1067,488,4398,1461,15571,Media-Baja,47,2021-09-30,257,488,4578,12157,20149,7992
2371,1468,1126,542,4135,1152,15088,Media-Baja,48,2021-09-30,280,483,5012,11557,20100,8543
2794,1790,826,422,5371,1557,16358,Media-Baja,49,2021-09-30,260,472,5456,13492,21814,8322
2757,1842,913,498,5188,1304,17385,Media-Baja,50,2021-09-30,257,498,5863,13257,23248,9991
1362,770,318,201,3490,598,9308,Baja,51,2021-09-30,170,153,831,7062,10139,3077
3869,3137,1949,889,5027,2617,34780,Media-Alta,52,2021-09-30,465,751,6991,18704,41771,23067
1350,877,350,183,3540,667,8648,Baja,53,2021-09-30,167,185,825,7319,9473,2154
4301,2797,2272,1134,7122,2251,31540,Media-Alta,54,2021-09-30,559,710,7878,21146,39418,18272
2674,1599,982,554,4062,1356,17288,Media-Baja,55,2021-09-30,221,616,4296,12064,21584,9520
1366,699,355,242,3669,630,8786,Baja,56,2021-09-30,166,177,864,7304,9650,2346
2642,1774,1078,447,4293,1034,15264,Media-Baja,57,2021-09-30,247,491,4655,12006,19919,7913
2437,1934,986,508,4766,1313,17038,Media-Baja,58,2021-09-30,244,524,4679,12712,21717,9005
3267,2609,2148,976,5103,2623,32994,Media-Alta,59,2021-09-30,486,720,8517,17932,41511,23579
2574,1528,1082,705,4757,1243,15421,Media-Baja,60,2021-09-30,252,543,4840,12684,20261,7577
2119,1599,1270,629,4631,1189,14745,Media-Baja,61,2021-09-30,253,413,5588,12103,20333,8230
3500,3109,2018,1132,5955,2431,27324,Media-Alta,62,2021-09-30,559,882,8325,19586,35649,16063
2619,1633,1098,536,5503,1370,14914,Media-Baja,63,2021-09-30,268,679,4778,13706,19692,5986
3811,2759,1797,946,5372,2835,25283,Media-Alta,64,2021-09-30,525,727,7632,18772,32915,14143
4831,2950,2476,998,7017,2081,32381,Media-Alta,65,2021-09-30,567,769,7766,21689,40147,18458
3528,3125,2062,1045,5080,2916,32663,Media-Alta,66,2021-09-30,399,683,8008,18838,40671,21833
4468,3298,2329,1094,6458,2392,29526,Media-Alta,67,2021-09-30,516,800,8210,21355,37736,16381
1275,751,349,213,4145,668,9537,Baja,69,2021-09-30,153,159,947,7713,10484,2771
2605,1808,1173,523,4418,1480,13851,Media-Baja,70,2021-09-30,318,569,4878,12894,18729,5835
5383,4079,3325,2073,8012,3521,66571,Alta,71,2021-09-30,5135,4854,16991,36382,83562,47180
1322,910,350,217,3524,668,8937,Baja,72,2021-09-30,154,168,985,7313,9922,2609
1438,774,444,219,3916,636,8798,Baja,73,2021-09-30,121,152,996,7700,9794,2094
2509,1434,1130,537,4675,906,15028,Media-Baja,74,2021-09-30,265,491,4854,11947,19882,7935
4201,2299,2235,855,6102,2875,29600,Media-Alta,75,2021-09-30,554,756,8524,19877,38124,18247
2811,1675,1043,481,4338,1127,15080,Media-Baja,76,2021-09-30,281,467,5068,12223,20148,7925
2698,1568,1036,537,5275,1484,14625,Media-Baja,77,2021-09-30,260,521,4592,13379,19217,5838
3529,3222,2294,960,6126,2483,29729,Media-Alta,79,2021-09-30,538,796,10839,19948,40568,20620
4077,2667,1800,1223,5065,2455,34261,Media-Alta,80,2021-09-30,465,807,8222,18559,42483,23924
2625,1623,1011,462,4738,1358,17245,Media-Baja,81,2021-09-30,283,734,5283,12834,22528,9694
1147,912,374,233,3674,542,9345,Baja,82,2021-09-30,173,145,827,7200,10172,2972
1401,879,424,220,3060,574,8726,Baja,83,2021-09-30,139,134,753,6831,9479,2648
2613,1445,1089,516,4807,1383,14850,Media-Baja,84,2021-09-30,271,521,4936,12645,19786,7141
1248,785,458,204,3720,740,7952,Baja,85,2021-09-30,162,132,854,7449,8806,1357
1382,601,343,195,3947,718,8352,Baja,86,2021-09-30,167,146,838,7499,9190,1691
3115,1525,1011,517,4691,1400,13794,Media-Baja,87,2021-09-30,237,558,5282,13054,19076,6022
2418,1828,1031,458,5499,1305,14801,Media-Baja,88,2021-09-30,275,495,5004,13309,19805,6496
1182,916,330,212,3390,774,8566,Baja,89,2021-09-30,164,155,940,7123,9506,2383
1227,850,336,239,3517,594,7123,Baja,90,2021-09-30,162,142,892,7067,8015,948
2713,1284,1133,521,4850,1052,15013,Media-Baja,91,2021-09-30,235,537,4290,12325,19303,6978
3646,3031,2443,1236,5828,2713,32098,Media-Alta,92,2021-09-30,540,831,6734,20268,38832,18564
2661,1751,1067,593,5832,1291,15407,Media-Baja,93,2021-09-30,302,453,4906,13950,20313,6363
2543,1592,1205,562,4708,1380,14248,Media-Baja,94,2021-09-30,244,533,4032,12767,18280,5513
3387,1513,1048,572,4847,1557,18280,Media-Baja,95,2021-09-30,268,613,4967,13805,23247,9442
1447,815,381,238,4107,702,8531,Baja,96,2021-09-30,157,174,769,8021,9300,1279
2731,1596,1192,449,3892,1284,14892,Media-Baja,97,2021-09-30,310,441,5041,11895,19933,8038
1215,744,361,184,3250,589,8999,Baja,98,2021-09-30,151,152,702,6646,9701,3055
2800,1486,1010,520,4983,1310,15614,Media-Baja,99,2021-09-30,279,614,4758,13002,20372,7370
3938,2823,1912,1062,6030,2502,25359,Media-Alta,0,2021-10-31,494,749,7480,19510,32839,13329
1177,850,407,178,3681,599,7369,Baja,1,2021-10-31,168,171,882,7231,8251,1020
2762,1367,874,549,4999,1222,14472,Media-Baja,2,2021-10-31,308,559,4237,12640,18709,6069
4218,2637,2255,1067,4744,2997,32933,Media-Alta,3,2021-10-31,394,817,7325,19129,40258,21129
1353,832,315,177,3263,602,10001,Baja,4,2021-10-31,147,163,783,6852,10784,3932
2742,1703,1077,501,4275,1281,15266,Media-Baja,5,2021-10-31,268,588,4998,12435,20264,7829
2463,1537,948,460,4937,1662,15962,Media-Baja,6,2021-10-31,240,484,5405,12731,21367,8636
4566,3971,2975,2247,8661,4616,85505,Alta,7,2021-10-31,5234,4552,15110,36822,100615,63793
4313,2617,2576,1113,7631,2710,32806,Media-Alta,8,2021-10-31,605,683,9503,22248,42309,20061
4562,3289,3268,2041,8368,4501,78258,Alta,9,2021-10-31,5031,5414,18901,36474,97159,60685
2656,1474,1217,595,5264,1342,17341,Media-Baja,10,2021-10-31,314,553,5344,13415,22685,9270
2320,1591,1205,493,5107,1366,14769,Media-Baja,11,2021-10-31,293,570,4971,12945,19740,6795
2923,1598,1077,613,5352,1400,16037,Media-Baja,12,2021-10-31,324,569,6425,13856,22462,8606
3962,3452,2242,1040,5499,2692,34648,Media-Alta,13,2021-10-31,378,771,7479,20036,42127,22091
2758,1620,964,483,5443,1331,13798,Media-Baja,14,2021-10-31,248,501,5720,13348,19518,6170
1387,598,400,201,4083,640,7498,Baja,15,2021-10-31,129,174,764,7612,8262,650
2419,1539,1132,595,5454,1373,14536,Media-Baja,16,2021-10-31,260,489,3873,13261,18409,5148
2757,1632,956,549,4540,1163,15721,Media-Baja,17,2021-10-31,275,456,4341,12328,20062,7734
2968,1439,904,472,4277,1124,17686,Media-Baja,18,2021-10-31,284,480,5208,11948,22894,10946
2870,1481,997,519,5495,1330,15661,Media-Baja,19,2021-10-31,247,524,4883,13463,20544,7081
2569,1418,866,534,4700,1306,17834,Media-Baja,20,2021-10-31,274,494,5529,12161,23363,11202
3773,2857,2062,1198,5716,2976,29428,Media-Alta,21,2021-10-31,498,776,6615,19856,36043,16187
4671,3760,2101,981,4895,3309,35835,Media-Alta,22,2021-10-31,482,794,7622,20993,43457,22464
2349,1422,1080,517,4728,1652,17283,Media-Baja,23,2021-10-31,246,445,5543,12439,22826,10387
1422,839,378,172,3228,557,8645,Baja,24,2021-10-31,179,154,878,6929,9523,2594
5760,4674,3894,1650,9416,4934,63611,Alta,25,2021-10-31,5150,5028,15816,40506,79427,38921
4231,3154,2447,1216,5928,2747,28664,Media-Alta,26,2021-10-31,487,938,7976,21148,36640,15492
1434,819,367,228,3180,653,8211,Baja,27,2021-10-31,145,156,829,6982,9040,2058
4105,2896,2025,1008,5877,2812,39154,Media-Alta,28,2021-10-31,533,736,9176,19992,48330,28338
1208,719,362,229,3775,698,8956,Baja,29,2021-10-31,174,183,912,7348,9868,2520
2515,1481,1088,449,4106,1535,16394,Media-Baja,30,2021-10-31,195,503,5063,11872,21457,9585
3447,3674,2005,1161,6343,2584,29260,Media-Alta,31,2021-10-31,508,814,7208,20536,36468,15932
1510,843,374,239,3985,538,8152,Baja,32,2021-10-31,174,185,996,7848,9148,1300
5644,4590,3104,1778,9087,4464,62916,Alta,33,2021-10-31,5509,4570,17009,38746,79925,41179
2258,1619,1031,512,3481,1029,16992,Media-Baja,34,2021-10-31,255,582,5103,10767,22095,11328
2596,1738,1092,469,4689,1026,15532,Media-Baja,35,2021-10-31,254,554,5165,12418,20697,8279
2584,1573,851,567,3749,1280,15776,Media-Baja,36,2021-10-31,286,542,4724,11432,20500,9068
2574,1329,1096,605,4581,1325,16039,Media-Baja,37,2021-10-31,278,505,4518,12293,20557,8264
2235,1696,944,445,5230,1375,15525,Media-Baja,38,2021-10-31,240,351,4420,12516,19945,7429
6469,4438,3060,2021,8398,3940,78138,Alta,39,2021-10-31,5363,3956,16850,37645,94988,57343
4872,3264,3683,1755,9347,4370,73689,Alta,40,2021-10-31,5835,4805,17007,37931,90696,52765
5394,4188,3044,1983,10734,4194,70688,Alta,41,2021-10-31,5149,4719,14341,39405,85029,45624
4068,2632,2089,1223,5420,2404,31329,Media-Alta,42,2021-10-31,567,801,7600,19204,38929,19725
5719,4194,3214,1952,7794,3907,83368,Alta,43,2021-10-31,4493,4703,17655,35976,101023,65047
6560,4479,4072,1681,8863,4387,68702,Alta,44,2021-10-31,5608,5375,18958,41025,87660,46635
3560,2822,1859,925,6087,2668,31016,Media-Alta,45,2021-10-31,543,643,6908,19107,37924,18817
3701,2901,1918,1315,5504,2570,29089,Media-Alta,46,2021-10-31,585,839,8323,19333,37412,18079
2454,1544,1067,488,4398,1461,15571,Media-Baja,47,2021-10-31,279,504,4408,12195,19979,7784
2371,1468,1126,542,4135,1152,15088,Media-Baja,48,2021-10-31,248,510,4392,11552,19480,7928
2794,1790,826,422,5371,1557,16358,Media-Baja,49,2021-10-31,283,617,5074,13660,21432,7772
2757,1842,913,498,5188,1304,17385,Media-Baja,50,2021-10-31,272,491,4810,13265,22195,8930
1362,770,318,201,3490,598,9308,Baja,51,2021-10-31,165,144,846,7048,10154,3106
3869,3137,1949,889,5027,2617,34780,Media-Alta,52,2021-10-31,598,787,6524,18873,41304,22431
1350,877,350,183,3540,667,8648,Baja,53,2021-10-31,132,137,841,7236,9489,2253
4301,2797,2272,1134,7122,2251,31540,Media-Alta,54,2021-10-31,566,683,7722,21126,39262,18136
2674,1599,982,554,4062,1356,17288,Media-Baja,55,2021-10-31,287,544,5195,12058,22483,10425
1366,699,355,242,3669,630,8786,Baja,56,2021-10-31,161,139,706,7261,9492,2231
2642,1774,1078,447,4293,1034,15264,Media-Baja,57,2021-10-31,264,485,4607,12017,19871,7854
2437,1934,986,508,4766,1313,17038,Media-Baja,58,2021-10-31,297,577,4253,12818,21291,8473
3267,2609,2148,976,5103,2623,32994,Media-Alta,59,2021-10-31,571,748,7263,18045,40257,22212
2574,1528,1082,705,4757,1243,15421,Media-Baja,60,2021-10-31,269,540,4355,12698,19776,7078
2119,1599,1270,629,4631,1189,14745,Media-Baja,61,2021-10-31,292,551,5473,12280,20218,7938
3500,3109,2018,1132,5955,2431,27324,Media-Alta,62,2021-10-31,456,834,7434,19435,34758,15323
2619,1633,1098,536,5503,1370,14914,Media-Baja,63,2021-10-31,258,548,5542,13565,20456,6891
3811,2759,1797,946,5372,2835,25283,Media-Alta,64,2021-10-31,438,786,9020,18744,34303,15559
4831,2950,2476,998,7017,2081,32381,Media-Alta,65,2021-10-31,552,896,8400,21801,40781,18980
3528,3125,2062,1045,5080,2916,32663,Media-Alta,66,2021-10-31,474,864,9073,19094,41736,22642
4468,3298,2329,1094,6458,2392,29526,Media-Alta,67,2021-10-31,496,911,9159,21446,38685,17239
1275,751,349,213,4145,668,9537,Baja,69,2021-10-31,164,152,1031,7717,10568,2851
2605,1808,1173,523,4418,1480,13851,Media-Baja,70,2021-10-31,247,443,4603,12697,18454,5757
5383,4079,3325,2073,8012,3521,66571,Alta,71,2021-10-31,5114,5046,16935,36553,83506,46953
1322,910,350,217,3524,668,8937,Baja,72,2021-10-31,172,154,742,7317,9679,2362
1438,774,444,219,3916,636,8798,Baja,73,2021-10-31,135,168,808,7730,9606,1876
2509,1434,1130,537,4675,906,15028,Media-Baja,74,2021-10-31,279,576,4778,12046,19806,7760
4201,2299,2235,855,6102,2875,29600,Media-Alta,75,2021-10-31,547,820,7972,19934,37572,17638
2811,1675,1043,481,4338,1127,15080,Media-Baja,76,2021-10-31,239,543,5557,12257,20637,8380
2698,1568,1036,537,5275,1484,14625,Media-Baja,77,2021-10-31,276,440,5283,13314,19908,6594
3529,3222,2294,960,6126,2483,29729,Media-Alta,79,2021-10-31,573,734,7668,19921,37397,17476
4077,2667,1800,1223,5065,2455,34261,Media-Alta,80,2021-10-31,511,807,8788,18605,43049,24444
2625,1623,1011,462,4738,1358,17245,Media-Baja,81,2021-10-31,228,504,5313,12549,22558,10009
1147,912,374,233,3674,542,9345,Baja,82,2021-10-31,127,154,904,7163,10249,3086
1401,879,424,220,3060,574,8726,Baja,83,2021-10-31,135,148,868,6841,9594,2753
2613,1445,1089,516,4807,1383,14850,Media-Baja,84,2021-10-31,257,508,4915,12618,19765,7147
1248,785,458,204,3720,740,7952,Baja,85,2021-10-31,148,145,871,7448,8823,1375
1382,601,343,195,3947,718,8352,Baja,86,2021-10-31,155,161,811,7502,9163,1661
3115,1525,1011,517,4691,1400,13794,Media-Baja,87,2021-10-31,293,504,4762,13056,18556,5500
2418,1828,1031,458,5499,1305,14801,Media-Baja,88,2021-10-31,289,549,5066,13377,19867,6490
1182,916,330,212,3390,774,8566,Baja,89,2021-10-31,173,162,885,7139,9451,2312
1227,850,336,239,3517,594,7123,Baja,90,2021-10-31,168,153,765,7084,7888,804
2713,1284,1133,521,4850,1052,15013,Media-Baja,91,2021-10-31,238,590,4135,12381,19148,6767
3646,3031,2443,1236,5828,2713,32098,Media-Alta,92,2021-10-31,501,768,8379,20166,40477,20311
2661,1751,1067,593,5832,1291,15407,Media-Baja,93,2021-10-31,253,505,4342,13953,19749,5796
2543,1592,1205,562,4708,1380,14248,Media-Baja,94,2021-10-31,272,449,4395,12711,18643,5932
3387,1513,1048,572,4847,1557,18280,Media-Baja,95,2021-10-31,272,544,5165,13740,23445,9705
1447,815,381,238,4107,702,8531,Baja,96,2021-10-31,149,154,866,7993,9397,1404
2731,1596,1192,449,3892,1284,14892,Media-Baja,97,2021-10-31,228,482,5177,11854,20069,8215
1215,744,361,184,3250,589,8999,Baja,98,2021-10-31,160,176,766,6679,9765,3086
2800,1486,1010,520,4983,1310,15614,Media-Baja,99,2021-10-31,316,561,5451,12986,21065,8079
3938,2823,1912,1062,6030,2502,25359,Media-Alta,0,2021-11-30,474,898,8138,19639,33497,13858
1177,850,407,178,3681,599,7369,Baja,1,2021-11-30,141,161,798,7194,8167,973
2762,1367,874,549,4999,1222,14472,Media-Baja,2,2021-11-30,254,576,5357,12603,19829,7226
4218,2637,2255,1067,4744,2997,32933,Media-Alta,3,2021-11-30,544,731,7769,19193,40702,21509
1353,832,315,177,3263,602,10001,Baja,4,2021-11-30,171,174,808,6887,10809,3922
2742,1703,1077,501,4275,1281,15266,Media-Baja,5,2021-11-30,242,553,5858,12374,21124,8750
2463,1537,948,460,4937,1662,15962,Media-Baja,6,2021-11-30,279,444,5048,12730,21010,8280
4566,3971,2975,2247,8661,4616,85505,Alta,7,2021-11-30,4869,4324,13891,36229,99396,63167
4313,2617,2576,1113,7631,2710,32806,Media-Alta,8,2021-11-30,587,747,7516,22294,40322,18028
4562,3289,3268,2041,8368,4501,78258,Alta,9,2021-11-30,5292,4862,17667,36183,95925,59742
2656,1474,1217,595,5264,1342,17341,Media-Baja,10,2021-11-30,279,497,5307,13324,22648,9324
2320,1591,1205,493,5107,1366,14769,Media-Baja,11,2021-11-30,235,458,5026,12775,19795,7020
2923,1598,1077,613,5352,1400,16037,Media-Baja,12,2021-11-30,329,576,3666,13868,19703,5835
3962,3452,2242,1040,5499,2692,34648,Media-Alta,13,2021-11-30,502,778,6727,20167,41375,21208
2758,1620,964,483,5443,1331,13798,Media-Baja,14,2021-11-30,209,429,5036,13237,18834,5597
1387,598,400,201,4083,640,7498,Baja,15,2021-11-30,154,156,846,7619,8344,725
2419,1539,1132,595,5454,1373,14536,Media-Baja,16,2021-11-30,309,531,5460,13352,19996,6644
2757,1632,956,549,4540,1163,15721,Media-Baja,17,2021-11-30,284,549,4971,12430,20692,8262
2968,1439,904,472,4277,1124,17686,Media-Baja,18,2021-11-30,294,511,5011,11989,22697,10708
2870,1481,997,519,5495,1330,15661,Media-Baja,19,2021-11-30,236,589,4783,13517,20444,6927
2569,1418,866,534,4700,1306,17834,Media-Baja,20,2021-11-30,218,483,5222,12094,23056,10962
3773,2857,2062,1198,5716,2976,29428,Media-Alta,21,2021-11-30,505,772,9059,19859,38487,18628
4671,3760,2101,981,4895,3309,35835,Media-Alta,22,2021-11-30,444,689,8946,20850,44781,23931
2349,1422,1080,517,4728,1652,17283,Media-Baja,23,2021-11-30,291,574,5281,12613,22564,9951
1422,839,378,172,3228,557,8645,Baja,24,2021-11-30,161,162,827,6919,9472,2553
5760,4674,3894,1650,9416,4934,63611,Alta,25,2021-11-30,5930,4693,18599,40951,82210,41259
4231,3154,2447,1216,5928,2747,28664,Media-Alta,26,2021-11-30,542,761,7329,21026,35993,14967
1434,819,367,228,3180,653,8211,Baja,27,2021-11-30,175,172,867,7028,9078,2050
4105,2896,2025,1008,5877,2812,39154,Media-Alta,28,2021-11-30,470,807,8258,20000,47412,27412
1208,719,362,229,3775,698,8956,Baja,29,2021-11-30,158,209,780,7358,9736,2378
2515,1481,1088,449,4106,1535,16394,Media-Baja,30,2021-11-30,264,542,5331,11980,21725,9745
3447,3674,2005,1161,6343,2584,29260,Media-Alta,31,2021-11-30,532,833,9031,20579,38291,17712
1510,843,374,239,3985,538,8152,Baja,32,2021-11-30,163,178,875,7830,9027,1197
5644,4590,3104,1778,9087,4464,62916,Alta,33,2021-11-30,4736,4948,20560,38351,83476,45125
2258,1619,1031,512,3481,1029,16992,Media-Baja,34,2021-11-30,299,619,6068,10848,23060,12212
2596,1738,1092,469,4689,1026,15532,Media-Baja,35,2021-11-30,260,479,4794,12349,20326,7977
2584,1573,851,567,3749,1280,15776,Media-Baja,36,2021-11-30,297,595,5890,11496,21666,10170
2574,1329,1096,605,4581,1325,16039,Media-Baja,37,2021-11-30,262,489,5136,12261,21175,8914
2235,1696,944,445,5230,1375,15525,Media-Baja,38,2021-11-30,261,549,3914,12735,19439,6704
6469,4438,3060,2021,8398,3940,78138,Alta,39,2021-11-30,4950,5286,15040,38562,93178,54616
4872,3264,3683,1755,9347,4370,73689,Alta,40,2021-11-30,5716,3652,16279,36659,89968,53309
5394,4188,3044,1983,10734,4194,70688,Alta,41,2021-11-30,5781,4194,20244,39512,90932,51420
4068,2632,2089,1223,5420,2404,31329,Media-Alta,42,2021-11-30,605,707,8196,19148,39525,20377
5719,4194,3214,1952,7794,3907,83368,Alta,43,2021-11-30,4946,5255,16603,36981,99971,62990
6560,4479,4072,1681,8863,4387,68702,Alta,44,2021-11-30,5358,4995,18330,40395,87032,46637
3560,2822,1859,925,6087,2668,31016,Media-Alta,45,2021-11-30,450,906,7816,19277,38832,19555
3701,2901,1918,1315,5504,2570,29089,Media-Alta,46,2021-11-30,416,805,7838,19130,36927,17797
2454,1544,1067,488,4398,1461,15571,Media-Baja,47,2021-11-30,270,525,5152,12207,20723,8516
2371,1468,1126,542,4135,1152,15088,Media-Baja,48,2021-11-30,299,499,5135,11592,20223,8631
2794,1790,826,422,5371,1557,16358,Media-Baja,49,2021-11-30,290,530,4926,13580,21284,7704
2757,1842,913,498,5188,1304,17385,Media-Baja,50,2021-11-30,268,529,4746,13299,22131,8832
1362,770,318,201,3490,598,9308,Baja,51,2021-11-30,153,171,803,7063,10111,3048
3869,3137,1949,889,5027,2617,34780,Media-Alta,52,2021-11-30,498,860,6758,18846,41538,22692
1350,877,350,183,3540,667,8648,Baja,53,2021-11-30,178,167,804,7312,9452,2140
4301,2797,2272,1134,7122,2251,31540,Media-Alta,54,2021-11-30,508,743,8811,21128,40351,19223
2674,1599,982,554,4062,1356,17288,Media-Baja,55,2021-11-30,291,525,4008,12043,21296,9253
1366,699,355,242,3669,630,8786,Baja,56,2021-11-30,160,184,1025,7305,9811,2506
2642,1774,1078,447,4293,1034,15264,Media-Baja,57,2021-11-30,287,439,4690,11994,19954,7960
2437,1934,986,508,4766,1313,17038,Media-Baja,58,2021-11-30,241,596,4358,12781,21396,8615
3267,2609,2148,976,5103,2623,32994,Media-Alta,59,2021-11-30,551,780,9236,18057,42230,24173
2574,1528,1082,705,4757,1243,15421,Media-Baja,60,2021-11-30,290,485,5009,12664,20430,7766
2119,1599,1270,629,4631,1189,14745,Media-Baja,61,2021-11-30,260,513,4923,12210,19668,7458
3500,3109,2018,1132,5955,2431,27324,Media-Alta,62,2021-11-30,545,864,8650,19554,35974,16420
2619,1633,1098,536,5503,1370,14914,Media-Baja,63,2021-11-30,287,591,5497,13637,20411,6774
3811,2759,1797,946,5372,2835,25283,Media-Alta,64,2021-11-30,492,841,9138,18853,34421,15568
4831,2950,2476,998,7017,2081,32381,Media-Alta,65,2021-11-30,513,827,7649,21693,40030,18337
3528,3125,2062,1045,5080,2916,32663,Media-Alta,66,2021-11-30,568,800,7794,19124,40457,21333
4468,3298,2329,1094,6458,2392,29526,Media-Alta,67,2021-11-30,555,792,7577,21386,37103,15717
1275,751,349,213,4145,668,9537,Baja,69,2021-11-30,183,163,870,7747,10407,2660
2605,1808,1173,523,4418,1480,13851,Media-Baja,70,2021-11-30,292,559,4512,12858,18363,5505
5383,4079,3325,2073,8012,3521,66571,Alta,71,2021-11-30,6223,4614,13264,37230,79835,42605
1322,910,350,217,3524,668,8937,Baja,72,2021-11-30,156,121,944,7268,9881,2613
1438,774,444,219,3916,636,8798,Baja,73,2021-11-30,171,159,769,7757,9567,1810
2509,1434,1130,537,4675,906,15028,Media-Baja,74,2021-11-30,261,583,5477,12035,20505,8470
4201,2299,2235,855,6102,2875,29600,Media-Alta,75,2021-11-30,517,774,7675,19858,37275,17417
2811,1675,1043,481,4338,1127,15080,Media-Baja,76,2021-11-30,294,554,4754,12323,19834,7511
2698,1568,1036,537,5275,1484,14625,Media-Baja,77,2021-11-30,279,463,4853,13340,19478,6138
3529,3222,2294,960,6126,2483,29729,Media-Alta,79,2021-11-30,557,795,7618,19966,37347,17381
4077,2667,1800,1223,5065,2455,34261,Media-Alta,80,2021-11-30,511,781,8073,18579,42334,23755
2625,1623,1011,462,4738,1358,17245,Media-Baja,81,2021-11-30,270,581,5303,12668,22548,9880
1147,912,374,233,3674,542,9345,Baja,82,2021-11-30,110,162,846,7154,10191,3037
1401,879,424,220,3060,574,8726,Baja,83,2021-11-30,164,149,888,6871,9614,2743
2613,1445,1089,516,4807,1383,14850,Media-Baja,84,2021-11-30,251,481,5100,12585,19950,7365
1248,785,458,204,3720,740,7952,Baja,85,2021-11-30,138,175,800,7468,8752,1284
1382,601,343,195,3947,718,8352,Baja,86,2021-11-30,153,162,901,7501,9253,1752
3115,1525,1011,517,4691,1400,13794,Media-Baja,87,2021-11-30,294,526,5574,13079,19368,6289
2418,1828,1031,458,5499,1305,14801,Media-Baja,88,2021-11-30,300,553,5005,13392,19806,6414
1182,916,330,212,3390,774,8566,Baja,89,2021-11-30,135,155,804,7094,9370,2276
1227,850,336,239,3517,594,7123,Baja,90,2021-11-30,156,165,833,7084,7956,872
2713,1284,1133,521,4850,1052,15013,Media-Baja,91,2021-11-30,205,569,4000,12327,19013,6686
3646,3031,2443,1236,5828,2713,32098,Media-Alta,92,2021-11-30,611,677,6822,20185,38920,18735
2661,1751,1067,593,5832,1291,15407,Media-Baja,93,2021-11-30,258,503,4354,13956,19761,5805
2543,1592,1205,562,4708,1380,14248,Media-Baja,94,2021-11-30,227,547,4145,12764,18393,5629
3387,1513,1048,572,4847,1557,18280,Media-Baja,95,2021-11-30,246,563,4742,13733,23022,9289
1447,815,381,238,4107,702,8531,Baja,96,2021-11-30,167,160,789,8017,9320,1303
2731,1596,1192,449,3892,1284,14892,Media-Baja,97,2021-11-30,256,500,4252,11900,19144,7244
1215,744,361,184,3250,589,8999,Baja,98,2021-11-30,149,137,726,6629,9725,3096
2800,1486,1010,520,4983,1310,15614,Media-Baja,99,2021-11-30,230,577,4556,12916,20170,7254
3938,2823,1912,1062,6030,2502,25359,Media-Alta,0,2021-12-31,506,858,8790,19631,34149,14518
1177,850,407,178,3681,599,7369,Baja,1,2021-12-31,168,157,953,7217,8322,1105
2762,1367,874,549,4999,1222,14472,Media-Baja,2,2021-12-31,279,567,5167,12619,19639,7020
4218,2637,2255,1067,4744,2997,32933,Media-Alta,3,2021-12-31,400,856,8210,19174,41143,21969
1353,832,315,177,3263,602,10001,Baja,4,2021-12-31,157,148,775,6847,10776,3929
2742,1703,1077,501,4275,1281,15266,Media-Baja,5,2021-12-31,288,512,4792,12379,20058,7679
2463,1537,948,460,4937,1662,15962,Media-Baja,6,2021-12-31,280,585,5504,12872,21466,8594
4566,3971,2975,2247,8661,4616,85505,Alta,7,2021-12-31,6042,5054,17655,38132,103160,65028
4313,2617,2576,1113,7631,2710,32806,Media-Alta,8,2021-12-31,574,718,8262,22252,41068,18816
4562,3289,3268,2041,8368,4501,78258,Alta,9,2021-12-31,5798,5208,17046,37035,95304,58269
2656,1474,1217,595,5264,1342,17341,Media-Baja,10,2021-12-31,272,543,5646,13363,22987,9624
2320,1591,1205,493,5107,1366,14769,Media-Baja,11,2021-12-31,262,563,4530,12907,19299,6392
2923,1598,1077,613,5352,1400,16037,Media-Baja,12,2021-12-31,223,519,4643,13705,20680,6975
3962,3452,2242,1040,5499,2692,34648,Media-Alta,13,2021-12-31,578,789,7835,20254,42483,22229
2758,1620,964,483,5443,1331,13798,Media-Baja,14,2021-12-31,274,498,5034,13371,18832,5461
1387,598,400,201,4083,640,7498,Baja,15,2021-12-31,165,181,865,7655,8363,708
2419,1539,1132,595,5454,1373,14536,Media-Baja,16,2021-12-31,243,558,4509,13313,19045,5732
2757,1632,956,549,4540,1163,15721,Media-Baja,17,2021-12-31,259,503,5364,12359,21085,8726
2968,1439,904,472,4277,1124,17686,Media-Baja,18,2021-12-31,276,517,5551,11977,23237,11260
2870,1481,997,519,5495,1330,15661,Media-Baja,19,2021-12-31,281,559,5757,13532,21418,7886
2569,1418,866,534,4700,1306,17834,Media-Baja,20,2021-12-31,238,491,4743,12122,22577,10455
3773,2857,2062,1198,5716,2976,29428,Media-Alta,21,2021-12-31,540,817,8114,19939,37542,17603
4671,3760,2101,981,4895,3309,35835,Media-Alta,22,2021-12-31,501,858,8856,21076,44691,23615
2349,1422,1080,517,4728,1652,17283,Media-Baja,23,2021-12-31,279,376,4250,12403,21533,9130
1422,839,378,172,3228,557,8645,Baja,24,2021-12-31,145,153,852,6894,9497,2603
5760,4674,3894,1650,9416,4934,63611,Alta,25,2021-12-31,7091,4731,17752,42150,81363,39213
4231,3154,2447,1216,5928,2747,28664,Media-Alta,26,2021-12-31,536,599,8820,20858,37484,16626
1434,819,367,228,3180,653,8211,Baja,27,2021-12-31,178,170,845,7029,9056,2027
4105,2896,2025,1008,5877,2812,39154,Media-Alta,28,2021-12-31,529,720,8094,19972,47248,27276
1208,719,362,229,3775,698,8956,Baja,29,2021-12-31,194,153,839,7338,9795,2457
2515,1481,1088,449,4106,1535,16394,Media-Baja,30,2021-12-31,228,504,4741,11906,21135,9229
3447,3674,2005,1161,6343,2584,29260,Media-Alta,31,2021-12-31,524,719,8760,20457,38020,17563
1510,843,374,239,3985,538,8152,Baja,32,2021-12-31,149,140,937,7778,9089,1311
5644,4590,3104,1778,9087,4464,62916,Alta,33,2021-12-31,4746,5040,17425,38453,80341,41888
2258,1619,1031,512,3481,1029,16992,Media-Baja,34,2021-12-31,275,477,5283,10682,22275,11593
2596,1738,1092,469,4689,1026,15532,Media-Baja,35,2021-12-31,239,499,4845,12348,20377,8029
2584,1573,851,567,3749,1280,15776,Media-Baja,36,2021-12-31,250,514,5594,11368,21370,10002
2574,1329,1096,605,4581,1325,16039,Media-Baja,37,2021-12-31,289,487,5386,12286,21425,9139
2235,1696,944,445,5230,1375,15525,Media-Baja,38,2021-12-31,316,556,5047,12797,20572,7775
6469,4438,3060,2021,8398,3940,78138,Alta,39,2021-12-31,5655,4236,15902,38217,94040,55823
4872,3264,3683,1755,9347,4370,73689,Alta,40,2021-12-31,4908,4443,16092,36642,89781,53139
5394,4188,3044,1983,10734,4194,70688,Alta,41,2021-12-31,5311,3944,15033,38792,85721,46929
4068,2632,2089,1223,5420,2404,31329,Media-Alta,42,2021-12-31,555,779,6074,19170,37403,18233
5719,4194,3214,1952,7794,3907,83368,Alta,43,2021-12-31,5743,4400,18612,36923,101980,65057
6560,4479,4072,1681,8863,4387,68702,Alta,44,2021-12-31,4776,4565,14814,39383,83516,44133
3560,2822,1859,925,6087,2668,31016,Media-Alta,45,2021-12-31,545,772,8803,19238,39819,20581
3701,2901,1918,1315,5504,2570,29089,Media-Alta,46,2021-12-31,580,777,7985,19266,37074,17808
2454,1544,1067,488,4398,1461,15571,Media-Baja,47,2021-12-31,291,559,4961,12262,20532,8270
2371,1468,1126,542,4135,1152,15088,Media-Baja,48,2021-12-31,259,499,5101,11552,20189,8637
2794,1790,826,422,5371,1557,16358,Media-Baja,49,2021-12-31,306,543,5357,13609,21715,8106
2757,1842,913,498,5188,1304,17385,Media-Baja,50,2021-12-31,254,573,4428,13329,21813,8484
1362,770,318,201,3490,598,9308,Baja,51,2021-12-31,148,163,701,7050,10009,2959
3869,3137,1949,889,5027,2617,34780,Media-Alta,52,2021-12-31,510,805,8216,18803,42996,24193
1350,877,350,183,3540,667,8648,Baja,53,2021-12-31,152,159,720,7278,9368,2090
4301,2797,2272,1134,7122,2251,31540,Media-Alta,54,2021-12-31,601,813,7535,21291,39075,17784
2674,1599,982,554,4062,1356,17288,Media-Baja,55,2021-12-31,294,538,5833,12059,23121,11062
1366,699,355,242,3669,630,8786,Baja,56,2021-12-31,146,151,830,7258,9616,2358
2642,1774,1078,447,4293,1034,15264,Media-Baja,57,2021-12-31,280,477,5106,12025,20370,8345
2437,1934,986,508,4766,1313,17038,Media-Baja,58,2021-12-31,275,556,4311,12775,21349,8574
3267,2609,2148,976,5103,2623,32994,Media-Alta,59,2021-12-31,569,786,7746,18081,40740,22659
2574,1528,1082,705,4757,1243,15421,Media-Baja,60,2021-12-31,253,491,4892,12633,20313,7680
2119,1599,1270,629,4631,1189,14745,Media-Baja,61,2021-12-31,241,518,5073,12196,19818,7622
3500,3109,2018,1132,5955,2431,27324,Media-Alta,62,2021-12-31,454,940,7828,19539,35152,15613
2619,1633,1098,536,5503,1370,14914,Media-Baja,63,2021-12-31,318,535,4742,13612,19656,6044
3811,2759,1797,946,5372,2835,25283,Media-Alta,64,2021-12-31,530,841,7597,18891,32880,13989
4831,2950,2476,998,7017,2081,32381,Media-Alta,65,2021-12-31,543,839,8241,21735,40622,18887
3528,3125,2062,1045,5080,2916,32663,Media-Alta,66,2021-12-31,623,918,7629,19297,40292,20995
4468,3298,2329,1094,6458,2392,29526,Media-Alta,67,2021-12-31,441,732,8305,21212,37831,16619
1275,751,349,213,4145,668,9537,Baja,69,2021-12-31,178,134,895,7713,10432,2719
2605,1808,1173,523,4418,1480,13851,Media-Baja,70,2021-12-31,252,530,4636,12789,18487,5698
5383,4079,3325,2073,8012,3521,66571,Alta,71,2021-12-31,4856,5594,17959,36843,84530,47687
1322,910,350,217,3524,668,8937,Baja,72,2021-12-31,154,164,813,7309,9750,2441
1438,774,444,219,3916,636,8798,Baja,73,2021-12-31,146,147,928,7720,9726,2006
2509,1434,1130,537,4675,906,15028,Media-Baja,74,2021-12-31,273,554,4988,12018,20016,7998
4201,2299,2235,855,6102,2875,29600,Media-Alta,75,2021-12-31,627,656,8299,19850,37899,18049
2811,1675,1043,481,4338,1127,15080,Media-Baja,76,2021-12-31,266,488,5031,12229,20111,7882
2698,1568,1036,537,5275,1484,14625,Media-Baja,77,2021-12-31,304,521,6991,13423,21616,8193
3529,3222,2294,960,6126,2483,29729,Media-Alta,79,2021-12-31,591,710,7316,19915,37045,17130
4077,2667,1800,1223,5065,2455,34261,Media-Alta,80,2021-12-31,535,854,7582,18676,41843,23167
2625,1623,1011,462,4738,1358,17245,Media-Baja,81,2021-12-31,219,495,4845,12531,22090,9559
1147,912,374,233,3674,542,9345,Baja,82,2021-12-31,163,163,719,7208,10064,2856
1401,879,424,220,3060,574,8726,Baja,83,2021-12-31,149,152,1008,6859,9734,2875
2613,1445,1089,516,4807,1383,14850,Media-Baja,84,2021-12-31,254,544,6005,12651,20855,8204
1248,785,458,204,3720,740,7952,Baja,85,2021-12-31,177,156,867,7488,8819,1331
1382,601,343,195,3947,718,8352,Baja,86,2021-12-31,175,161,840,7522,9192,1670
3115,1525,1011,517,4691,1400,13794,Media-Baja,87,2021-12-31,267,543,4364,13069,18158,5089
2418,1828,1031,458,5499,1305,14801,Media-Baja,88,2021-12-31,299,566,4659,13404,19460,6056
1182,916,330,212,3390,774,8566,Baja,89,2021-12-31,145,177,705,7126,9271,2145
1227,850,336,239,3517,594,7123,Baja,90,2021-12-31,157,182,967,7102,8090,988
2713,1284,1133,521,4850,1052,15013,Media-Baja,91,2021-12-31,262,534,4403,12349,19416,7067
3646,3031,2443,1236,5828,2713,32098,Media-Alta,92,2021-12-31,605,740,8099,20242,40197,19955
2661,1751,1067,593,5832,1291,15407,Media-Baja,93,2021-12-31,252,489,4932,13936,20339,6403
2543,1592,1205,562,4708,1380,14248,Media-Baja,94,2021-12-31,242,557,4332,12789,18580,5791
3387,1513,1048,572,4847,1557,18280,Media-Baja,95,2021-12-31,286,560,5274,13770,23554,9784
1447,815,381,238,4107,702,8531,Baja,96,2021-12-31,175,171,908,8036,9439,1403
2731,1596,1192,449,3892,1284,14892,Media-Baja,97,2021-12-31,279,541,5088,11964,19980,8016
1215,744,361,184,3250,589,8999,Baja,98,2021-12-31,177,162,929,6682,9928,3246
2800,1486,1010,520,4983,1310,15614,Media-Baja,99,2021-12-31,259,505,5163,12873,20777,7904
4250,3046,2063,1146,6507,2700,27363,Media-Alta,0,2022-01-31,515,865,7290,21092,34653,13561
1270,917,439,192,3972,647,7952,Baja,1,2022-01-31,154,172,1043,7763,8995,1232
2980,1475,943,592,5394,1319,15615,Media-Baja,2,2022-01-31,280,615,3900,13598,19515,5917
4551,2846,2433,1151,5119,3234,35535,Media-Alta,3,2022-01-31,540,828,8603,20702,44138,23436
1460,897,340,191,3520,650,10791,Baja,4,2022-01-31,167,173,640,7398,11431,4033
2959,1837,1162,541,4613,1383,16472,Media-Baja,5,2022-01-31,264,693,4373,13452,20845,7393
2658,1659,1023,496,5327,1793,17223,Media-Baja,6,2022-01-31,296,568,4722,13820,21945,8125
4926,4285,3210,2424,9345,4981,92260,Alta,7,2022-01-31,5143,5224,15414,39538,107674,68136
4654,2824,2780,1200,8234,2924,35398,Media-Alta,8,2022-01-31,581,903,7252,24100,42650,18550
4923,3549,3526,2202,9029,4857,84440,Alta,9,2022-01-31,5972,5955,18449,40013,102889,62876
2866,1590,1313,642,5680,1448,18711,Media-Baja,10,2022-01-31,251,541,4641,14331,23352,9021
2503,1717,1301,532,5511,1474,15935,Media-Baja,11,2022-01-31,274,579,4679,13891,20614,6723
3153,1725,1162,662,5775,1510,17304,Media-Baja,12,2022-01-31,254,587,5240,14828,22544,7716
4275,3724,2420,1122,5934,2905,37385,Media-Alta,13,2022-01-31,615,864,7833,21859,45218,23359
2976,1749,1040,521,5873,1436,14888,Media-Baja,14,2022-01-31,297,576,4448,14468,19336,4868
1497,646,431,217,4406,691,8091,Baja,15,2022-01-31,180,183,817,8251,8908,657
2610,1661,1221,642,5885,1482,15685,Media-Baja,16,2022-01-31,218,512,4883,14231,20568,6337
2975,1761,1032,592,4899,1255,16963,Media-Baja,17,2022-01-31,314,569,5037,13397,22000,8603
3202,1553,976,509,4615,1213,19084,Media-Baja,18,2022-01-31,266,641,4851,12975,23935,10960
3096,1598,1076,560,5929,1435,16898,Media-Baja,19,2022-01-31,306,594,5580,14594,22478,7884
2772,1530,935,576,5071,1409,19243,Media-Baja,20,2022-01-31,276,550,5147,13119,24390,11271
4071,3083,2225,1293,6167,3212,31753,Media-Alta,21,2022-01-31,607,987,9084,21645,40837,19192
5040,4057,2267,1058,5282,3570,38666,Media-Alta,22,2022-01-31,535,836,8265,22645,46931,24286
2535,1534,1165,558,5102,1783,18648,Media-Baja,23,2022-01-31,256,576,4787,13509,23435,9926
1534,905,407,185,3483,601,9328,Baja,24,2022-01-31,182,190,878,7487,10206,2719
6215,5044,4202,1780,10160,5324,68636,Alta,25,2022-01-31,5570,5370,20124,43665,88760,45095
4565,3403,2641,1312,6396,2964,30928,Media-Alta,26,2022-01-31,510,823,7642,22614,38570,15956
1547,884,396,246,3431,705,8860,Baja,27,2022-01-31,154,174,865,7537,9725,2188
4430,3125,2185,1088,6342,3034,42247,Media-Alta,28,2022-01-31,560,954,7257,21718,49504,27786
1303,775,390,247,4073,753,9664,Baja,29,2022-01-31,182,172,796,7895,10460,2565
2714,1598,1174,485,4431,1656,17689,Media-Baja,30,2022-01-31,323,458,4688,12839,22377,9538
3720,3965,2163,1253,6844,2788,31572,Media-Alta,31,2022-01-31,697,905,8949,22335,40521,18186
1629,910,404,258,4300,581,8796,Baja,32,2022-01-31,146,161,870,8389,9666,1277
6090,4953,3349,1918,9805,4817,67886,Alta,33,2022-01-31,6017,4788,15730,41737,83616,41879
2437,1747,1113,552,3756,1110,18334,Media-Baja,34,2022-01-31,372,578,5256,11665,23590,11925
2801,1875,1179,507,5060,1107,16759,Media-Baja,35,2022-01-31,332,548,5759,13409,22518,9109
2788,1697,918,611,4046,1382,17022,Media-Baja,36,2022-01-31,284,551,4179,12277,21201,8924
2777,1434,1182,652,4943,1429,17306,Media-Baja,37,2022-01-31,285,623,3919,13325,21225,7900
2412,1831,1018,480,5643,1484,16751,Media-Baja,38,2022-01-31,296,585,3896,13749,20647,6898
6980,4788,3302,2180,9061,4252,84311,Alta,39,2022-01-31,6143,4767,17802,41473,102113,60640
5257,3521,3974,1893,10086,4716,79511,Alta,40,2022-01-31,6231,4996,17460,40674,96971,56297
5820,4518,3284,2139,11582,4525,76273,Alta,41,2022-01-31,6526,4834,17089,43228,93362,50134
4390,2840,2254,1320,5848,2594,33804,Media-Alta,42,2022-01-31,530,726,7337,20502,41141,20639
6171,4525,3468,2106,8410,4215,89954,Alta,43,2022-01-31,6375,4279,13928,39549,103882,64333
7079,4833,4394,1813,9563,4734,74129,Alta,44,2022-01-31,5926,4365,16242,42707,90371,47664
3842,3045,2006,998,6568,2879,33467,Media-Alta,45,2022-01-31,560,805,7912,20703,41379,20676
3993,3131,2070,1419,5939,2773,31387,Media-Alta,46,2022-01-31,664,867,9296,20856,40683,19827
2648,1666,1151,527,4745,1576,16801,Media-Baja,47,2022-01-31,262,579,5568,13154,22369,9215
2559,1584,1215,585,4461,1243,16280,Media-Baja,48,2022-01-31,275,394,5080,12316,21360,9044
3014,1932,892,455,5796,1680,17650,Media-Baja,49,2022-01-31,317,655,4502,14741,22152,7411
2975,1988,985,537,5597,1407,18759,Media-Baja,50,2022-01-31,259,626,5778,14374,24537,10163
1469,831,344,217,3765,646,10044,Baja,51,2022-01-31,156,174,845,7602,10889,3287
4174,3385,2103,959,5424,2824,37528,Media-Alta,52,2022-01-31,560,911,7835,20340,45363,25023
1457,946,378,198,3820,720,9331,Baja,53,2022-01-31,142,152,1042,7813,10373,2560
4640,3018,2452,1223,7685,2429,34032,Media-Alta,54,2022-01-31,597,902,8364,22946,42396,19450
2886,1726,1059,598,4383,1464,18654,Media-Baja,55,2022-01-31,373,546,4789,13035,23443,10408
1474,754,383,262,3959,680,9481,Baja,56,2022-01-31,152,158,698,7822,10179,2357
2850,1914,1163,483,4632,1116,16470,Media-Baja,57,2022-01-31,352,557,4929,13067,21399,8332
2629,2087,1064,549,5143,1417,18384,Media-Baja,58,2022-01-31,264,673,4749,13826,23133,9307
3525,2815,2318,1053,5506,2830,35601,Media-Alta,59,2022-01-31,557,782,6188,19386,41789,22403
2777,1648,1167,761,5133,1342,16640,Media-Baja,60,2022-01-31,276,485,4926,13589,21566,7977
2286,1726,1370,679,4997,1282,15910,Media-Baja,61,2022-01-31,288,672,5484,13300,21394,8094
3777,3355,2177,1221,6426,2624,29482,Media-Alta,62,2022-01-31,489,749,7370,20818,36852,16034
2826,1762,1185,578,5938,1478,16093,Media-Baja,63,2022-01-31,273,469,5183,14509,21276,6767
4112,2977,1939,1020,5797,3059,27281,Media-Alta,64,2022-01-31,591,794,8953,20289,36234,15945
5212,3183,2671,1077,7571,2245,34939,Media-Alta,65,2022-01-31,589,787,7557,23335,42496,19161
3806,3372,2225,1128,5481,3147,35243,Media-Alta,66,2022-01-31,577,748,7126,20484,42369,21885
4822,3559,2513,1180,6968,2581,31859,Media-Alta,67,2022-01-31,597,794,6951,23014,38810,15796
1376,811,377,230,4473,721,10291,Baja,69,2022-01-31,193,168,868,8349,11159,2810
2810,1951,1265,565,4767,1597,14945,Media-Baja,70,2022-01-31,256,538,5305,13749,20250,6501
5808,4401,3588,2237,8645,3799,71830,Alta,71,2022-01-31,6017,5681,16097,40176,87927,47751
1426,982,378,234,3803,721,9644,Baja,72,2022-01-31,157,181,982,7882,10626,2744
1551,835,479,237,4226,687,9493,Baja,73,2022-01-31,170,142,924,8327,10417,2090
2707,1547,1220,579,5045,977,16216,Media-Baja,74,2022-01-31,263,613,4658,12951,20874,7923
4533,2481,2412,922,6584,3102,31939,Media-Alta,75,2022-01-31,507,794,8479,21335,40418,19083
3033,1808,1125,519,4680,1216,16272,Media-Baja,76,2022-01-31,314,474,5395,13169,21667,8498
2911,1692,1118,579,5692,1602,15781,Media-Baja,77,2022-01-31,292,530,5065,14416,20846,6430
3807,3477,2475,1036,6610,2679,32078,Media-Alta,79,2022-01-31,608,721,9152,21413,41230,19817
4399,2878,1942,1320,5465,2649,36968,Media-Alta,80,2022-01-31,462,764,8334,19879,45302,25423
2832,1751,1091,499,5112,1465,18607,Media-Baja,81,2022-01-31,240,549,5034,13539,23641,10102
1238,984,404,251,3965,585,10083,Baja,82,2022-01-31,200,160,949,7787,11032,3245
1512,949,458,238,3302,619,9416,Baja,83,2022-01-31,173,150,639,7401,10055,2654
2820,1559,1175,557,5187,1492,16023,Media-Baja,84,2022-01-31,305,605,3417,13700,19440,5740
1346,847,494,221,4014,798,8581,Baja,85,2022-01-31,139,200,971,8059,9552,1493
1491,649,370,210,4259,774,9012,Baja,86,2022-01-31,145,150,799,8048,9811,1763
3361,1646,1091,558,5062,1510,14884,Media-Baja,87,2022-01-31,257,700,6054,14185,20938,6753
2609,1973,1113,494,5934,1408,15971,Media-Baja,88,2022-01-31,300,573,5474,14404,21445,7041
1276,989,356,229,3658,835,9243,Baja,89,2022-01-31,188,154,754,7685,9997,2312
1324,917,363,258,3795,641,7686,Baja,90,2022-01-31,192,180,832,7670,8518,848
2928,1385,1222,562,5233,1136,16199,Media-Baja,91,2022-01-31,268,553,4082,13287,20281,6994
3934,3271,2636,1334,6288,2928,34633,Media-Alta,92,2022-01-31,541,810,7849,21742,42482,20740
2871,1890,1151,640,6293,1393,16624,Media-Baja,93,2022-01-31,279,592,4678,15109,21302,6193
2744,1718,1301,607,5080,1489,15374,Media-Baja,94,2022-01-31,297,500,5729,13736,21103,7367
3655,1632,1131,617,5229,1680,19724,Media-Baja,95,2022-01-31,298,650,5641,14892,25365,10473
1562,879,411,257,4432,757,9205,Baja,96,2022-01-31,151,193,866,8642,10071,1429
2947,1722,1286,485,4199,1385,16069,Media-Baja,97,2022-01-31,259,495,4062,12778,20131,7353
1311,803,389,199,3507,635,9710,Baja,98,2022-01-31,167,182,801,7193,10511,3318
3021,1604,1090,561,5376,1414,16847,Media-Baja,99,2022-01-31,319,575,5291,13960,22138,8178
4250,3046,2063,1146,6507,2700,27363,Media-Alta,0,2022-02-28,579,838,8601,21129,35964,14835
1270,917,439,192,3972,647,7952,Baja,1,2022-02-28,159,154,838,7750,8790,1040
2980,1475,943,592,5394,1319,15615,Media-Baja,2,2022-02-28,299,644,5351,13646,20966,7320
4551,2846,2433,1151,5119,3234,35535,Media-Alta,3,2022-02-28,554,832,8602,20720,44137,23417
1460,897,340,191,3520,650,10791,Baja,4,2022-02-28,186,164,721,7408,11512,4104
2959,1837,1162,541,4613,1383,16472,Media-Baja,5,2022-02-28,275,624,4314,13394,20786,7392
2658,1659,1023,496,5327,1793,17223,Media-Baja,6,2022-02-28,308,657,4343,13921,21566,7645
4926,4285,3210,2424,9345,4981,92260,Alta,7,2022-02-28,5478,5306,18072,39955,110332,70377
4654,2824,2780,1200,8234,2924,35398,Media-Alta,8,2022-02-28,574,827,8197,24017,43595,19578
4923,3549,3526,2202,9029,4857,84440,Alta,9,2022-02-28,5420,4446,17419,37952,101859,63907
2866,1590,1313,642,5680,1448,18711,Media-Baja,10,2022-02-28,315,494,4744,14348,23455,9107
2503,1717,1301,532,5511,1474,15935,Media-Baja,11,2022-02-28,304,527,5157,13869,21092,7223
3153,1725,1162,662,5775,1510,17304,Media-Baja,12,2022-02-28,301,553,4905,14841,22209,7368
4275,3724,2420,1122,5934,2905,37385,Media-Alta,13,2022-02-28,655,952,8251,21987,45636,23649
2976,1749,1040,521,5873,1436,14888,Media-Baja,14,2022-02-28,323,611,5148,14529,20036,5507
1497,646,431,217,4406,691,8091,Baja,15,2022-02-28,194,144,996,8226,9087,861
2610,1661,1221,642,5885,1482,15685,Media-Baja,16,2022-02-28,297,522,4914,14320,20599,6279
2975,1761,1032,592,4899,1255,16963,Media-Baja,17,2022-02-28,273,510,4672,13297,21635,8338
3202,1553,976,509,4615,1213,19084,Media-Baja,18,2022-02-28,328,469,5804,12865,24888,12023
3096,1598,1076,560,5929,1435,16898,Media-Baja,19,2022-02-28,248,599,4314,14541,21212,6671
2772,1530,935,576,5071,1409,19243,Media-Baja,20,2022-02-28,260,541,4859,13094,24102,11008
4071,3083,2225,1293,6167,3212,31753,Media-Alta,21,2022-02-28,696,749,7920,21496,39673,18177
5040,4057,2267,1058,5282,3570,38666,Media-Alta,22,2022-02-28,439,929,8235,22642,46901,24259
2535,1534,1165,558,5102,1783,18648,Media-Baja,23,2022-02-28,264,611,6282,13552,24930,11378
1534,905,407,185,3483,601,9328,Baja,24,2022-02-28,158,177,840,7450,10168,2718
6215,5044,4202,1780,10160,5324,68636,Alta,25,2022-02-28,5043,6082,17966,43850,86602,42752
4565,3403,2641,1312,6396,2964,30928,Media-Alta,26,2022-02-28,600,936,8728,22817,39656,16839
1547,884,396,246,3431,705,8860,Baja,27,2022-02-28,153,185,879,7547,9739,2192
4430,3125,2185,1088,6342,3034,42247,Media-Alta,28,2022-02-28,642,785,8626,21631,50873,29242
1303,775,390,247,4073,753,9664,Baja,29,2022-02-28,195,172,758,7908,10422,2514
2714,1598,1174,485,4431,1656,17689,Media-Baja,30,2022-02-28,258,543,5540,12859,23229,10370
3720,3965,2163,1253,6844,2788,31572,Media-Alta,31,2022-02-28,654,798,5930,22185,37502,15317
1629,910,404,258,4300,581,8796,Baja,32,2022-02-28,168,148,845,8398,9641,1243
6090,4953,3349,1918,9805,4817,67886,Alta,33,2022-02-28,6315,5889,15609,43136,83495,40359
2437,1747,1113,552,3756,1110,18334,Media-Baja,34,2022-02-28,287,505,5265,11507,23599,12092
2801,1875,1179,507,5060,1107,16759,Media-Baja,35,2022-02-28,250,566,5279,13345,22038,8693
2788,1697,918,611,4046,1382,17022,Media-Baja,36,2022-02-28,264,622,5409,12328,22431,10103
2777,1434,1182,652,4943,1429,17306,Media-Baja,37,2022-02-28,250,562,6086,13229,23392,10163
2412,1831,1018,480,5643,1484,16751,Media-Baja,38,2022-02-28,276,528,4524,13672,21275,7603
6980,4788,3302,2180,9061,4252,84311,Alta,39,2022-02-28,5374,4392,14752,40329,99063,58734
5257,3521,3974,1893,10086,4716,79511,Alta,40,2022-02-28,5575,6683,17059,41705,96570,54865
5820,4518,3284,2139,11582,4525,76273,Alta,41,2022-02-28,5169,4685,18551,41722,94824,53102
4390,2840,2254,1320,5848,2594,33804,Media-Alta,42,2022-02-28,640,762,9080,20648,42884,22236
6171,4525,3468,2106,8410,4215,89954,Alta,43,2022-02-28,6074,4686,17113,39655,107067,67412
7079,4833,4394,1813,9563,4734,74129,Alta,44,2022-02-28,6843,5113,17539,44372,91668,47296
3842,3045,2006,998,6568,2879,33467,Media-Alta,45,2022-02-28,568,831,8813,20737,42280,21543
3993,3131,2070,1419,5939,2773,31387,Media-Alta,46,2022-02-28,541,861,7830,20727,39217,18490
2648,1666,1151,527,4745,1576,16801,Media-Baja,47,2022-02-28,268,590,5579,13171,22380,9209
2559,1584,1215,585,4461,1243,16280,Media-Baja,48,2022-02-28,221,598,5489,12466,21769,9303
3014,1932,892,455,5796,1680,17650,Media-Baja,49,2022-02-28,319,584,4683,14672,22333,7661
2975,1988,985,537,5597,1407,18759,Media-Baja,50,2022-02-28,260,681,5282,14430,24041,9611
1469,831,344,217,3765,646,10044,Baja,51,2022-02-28,154,176,794,7602,10838,3236
4174,3385,2103,959,5424,2824,37528,Media-Alta,52,2022-02-28,470,884,8179,20223,45707,25484
1457,946,378,198,3820,720,9331,Baja,53,2022-02-28,178,168,938,7865,10269,2404
4640,3018,2452,1223,7685,2429,34032,Media-Alta,54,2022-02-28,525,820,9673,22792,43705,20913
2886,1726,1059,598,4383,1464,18654,Media-Baja,55,2022-02-28,271,489,4874,12876,23528,10652
1474,754,383,262,3959,680,9481,Baja,56,2022-02-28,167,166,798,7845,10279,2434
2850,1914,1163,483,4632,1116,16470,Media-Baja,57,2022-02-28,303,581,4842,13042,21312,8270
2629,2087,1064,549,5143,1417,18384,Media-Baja,58,2022-02-28,275,567,3748,13731,22132,8401
3525,2815,2318,1053,5506,2830,35601,Media-Alta,59,2022-02-28,511,859,7927,19417,43528,24111
2777,1648,1167,761,5133,1342,16640,Media-Baja,60,2022-02-28,306,518,4532,13652,21172,7520
2286,1726,1370,679,4997,1282,15910,Media-Baja,61,2022-02-28,256,711,5584,13307,21494,8187
3777,3355,2177,1221,6426,2624,29482,Media-Alta,62,2022-02-28,657,914,7893,21151,37375,16224
2826,1762,1185,578,5938,1478,16093,Media-Baja,63,2022-02-28,278,464,3818,14509,19911,5402
4112,2977,1939,1020,5797,3059,27281,Media-Alta,64,2022-02-28,660,871,7191,20435,34472,14037
5212,3183,2671,1077,7571,2245,34939,Media-Alta,65,2022-02-28,601,902,8268,23462,43207,19745
3806,3372,2225,1128,5481,3147,35243,Media-Alta,66,2022-02-28,606,873,7320,20638,42563,21925
4822,3559,2513,1180,6968,2581,31859,Media-Alta,67,2022-02-28,630,1043,6870,23296,38729,15433
1376,811,377,230,4473,721,10291,Baja,69,2022-02-28,190,182,887,8360,11178,2818
2810,1951,1265,565,4767,1597,14945,Media-Baja,70,2022-02-28,309,486,5391,13750,20336,6586
5808,4401,3588,2237,8645,3799,71830,Alta,71,2022-02-28,6320,4735,16550,39533,88380,48847
1426,982,378,234,3803,721,9644,Baja,72,2022-02-28,178,151,881,7873,10525,2652
1551,835,479,237,4226,687,9493,Baja,73,2022-02-28,150,165,753,8330,10246,1916
2707,1547,1220,579,5045,977,16216,Media-Baja,74,2022-02-28,296,622,5640,12993,21856,8863
4533,2481,2412,922,6584,3102,31939,Media-Alta,75,2022-02-28,615,903,7216,21552,39155,17603
3033,1808,1125,519,4680,1216,16272,Media-Baja,76,2022-02-28,304,546,5245,13231,21517,8286
2911,1692,1118,579,5692,1602,15781,Media-Baja,77,2022-02-28,292,592,4344,14478,20125,5647
3807,3477,2475,1036,6610,2679,32078,Media-Alta,79,2022-02-28,628,1001,7765,21713,39843,18130
4399,2878,1942,1320,5465,2649,36968,Media-Alta,80,2022-02-28,548,679,8254,19880,45222,25342
2832,1751,1091,499,5112,1465,18607,Media-Baja,81,2022-02-28,307,475,5017,13532,23624,10092
1238,984,404,251,3965,585,10083,Baja,82,2022-02-28,153,168,933,7748,11016,3268
1512,949,458,238,3302,619,9416,Baja,83,2022-02-28,175,133,842,7386,10258,2872
2820,1559,1175,557,5187,1492,16023,Media-Baja,84,2022-02-28,311,520,4879,13621,20902,7281
1346,847,494,221,4014,798,8581,Baja,85,2022-02-28,173,177,837,8070,9418,1348
1491,649,370,210,4259,774,9012,Baja,86,2022-02-28,167,168,1056,8088,10068,1980
3361,1646,1091,558,5062,1510,14884,Media-Baja,87,2022-02-28,299,561,4952,14088,19836,5748
2609,1973,1113,494,5934,1408,15971,Media-Baja,88,2022-02-28,274,594,5478,14399,21449,7050
1276,989,356,229,3658,835,9243,Baja,89,2022-02-28,177,157,932,7677,10175,2498
1324,917,363,258,3795,641,7686,Baja,90,2022-02-28,160,181,855,7639,8541,902
2928,1385,1222,562,5233,1136,16199,Media-Baja,91,2022-02-28,324,414,4926,13204,21125,7921
3934,3271,2636,1334,6288,2928,34633,Media-Alta,92,2022-02-28,607,811,7159,21809,41792,19983
2871,1890,1151,640,6293,1393,16624,Media-Baja,93,2022-02-28,316,590,4977,15144,21601,6457
2744,1718,1301,607,5080,1489,15374,Media-Baja,94,2022-02-28,319,512,4966,13770,20340,6570
3655,1632,1131,617,5229,1680,19724,Media-Baja,95,2022-02-28,267,597,5033,14808,24757,9949
1562,879,411,257,4432,757,9205,Baja,96,2022-02-28,154,183,985,8635,10190,1555
2947,1722,1286,485,4199,1385,16069,Media-Baja,97,2022-02-28,241,545,4850,12810,20919,8109
1311,803,389,199,3507,635,9710,Baja,98,2022-02-28,215,169,835,7228,10545,3317
3021,1604,1090,561,5376,1414,16847,Media-Baja,99,2022-02-28,282,487,5248,13835,22095,8260
4250,3046,2063,1146,6507,2700,27363,Media-Alta,0,2022-03-31,429,803,8351,20944,35714,14770
1270,917,439,192,3972,647,7952,Baja,1,2022-03-31,169,165,951,7771,8903,1132
2980,1475,943,592,5394,1319,15615,Media-Baja,2,2022-03-31,288,597,5058,13588,20673,7085
4551,2846,2433,1151,5119,3234,35535,Media-Alta,3,2022-03-31,532,963,7293,20829,42828,21999
1460,897,340,191,3520,650,10791,Baja,4,2022-03-31,154,173,774,7385,11565,4180
2959,1837,1162,541,4613,1383,16472,Media-Baja,5,2022-03-31,317,471,4419,13283,20891,7608
2658,1659,1023,496,5327,1793,17223,Media-Baja,6,2022-03-31,332,677,4784,13965,22007,8042
4926,4285,3210,2424,9345,4981,92260,Alta,7,2022-03-31,5934,5212,17151,40317,109411,69094
4654,2824,2780,1200,8234,2924,35398,Media-Alta,8,2022-03-31,561,877,9594,24054,44992,20938
4923,3549,3526,2202,9029,4857,84440,Alta,9,2022-03-31,5743,5440,16030,39269,100470,61201
2866,1590,1313,642,5680,1448,18711,Media-Baja,10,2022-03-31,273,455,5283,14267,23994,9727
2503,1717,1301,532,5511,1474,15935,Media-Baja,11,2022-03-31,304,567,5768,13909,21703,7794
3153,1725,1162,662,5775,1510,17304,Media-Baja,12,2022-03-31,313,589,4876,14889,22180,7291
4275,3724,2420,1122,5934,2905,37385,Media-Alta,13,2022-03-31,496,821,9533,21697,46918,25221
2976,1749,1040,521,5873,1436,14888,Media-Baja,14,2022-03-31,315,651,5551,14561,20439,5878
1497,646,431,217,4406,691,8091,Baja,15,2022-03-31,184,148,751,8220,8842,622
2610,1661,1221,642,5885,1482,15685,Media-Baja,16,2022-03-31,252,614,4666,14367,20351,5984
2975,1761,1032,592,4899,1255,16963,Media-Baja,17,2022-03-31,270,545,4589,13329,21552,8223
3202,1553,976,509,4615,1213,19084,Media-Baja,18,2022-03-31,241,510,5066,12819,24150,11331
3096,1598,1076,560,5929,1435,16898,Media-Baja,19,2022-03-31,271,652,4967,14617,21865,7248
2772,1530,935,576,5071,1409,19243,Media-Baja,20,2022-03-31,300,762,4809,13355,24052,10697
4071,3083,2225,1293,6167,3212,31753,Media-Alta,21,2022-03-31,722,884,8342,21657,40095,18438
5040,4057,2267,1058,5282,3570,38666,Media-Alta,22,2022-03-31,554,879,8370,22707,47036,24329
2535,1534,1165,558,5102,1783,18648,Media-Baja,23,2022-03-31,279,611,5031,13567,23679,10112
1534,905,407,185,3483,601,9328,Baja,24,2022-03-31,178,189,861,7482,10189,2707
6215,5044,4202,1780,10160,5324,68636,Alta,25,2022-03-31,6455,4923,17551,44103,86187,42084
4565,3403,2641,1312,6396,2964,30928,Media-Alta,26,2022-03-31,615,1016,7875,22912,38803,15891
1547,884,396,246,3431,705,8860,Baja,27,2022-03-31,194,151,741,7554,9601,2047
4430,3125,2185,1088,6342,3034,42247,Media-Alta,28,2022-03-31,552,922,8233,21678,50480,28802
1303,775,390,247,4073,753,9664,Baja,29,2022-03-31,157,168,750,7866,10414,2548
2714,1598,1174,485,4431,1656,17689,Media-Baja,30,2022-03-31,249,551,4305,12858,21994,9136
3720,3965,2163,1253,6844,2788,31572,Media-Alta,31,2022-03-31,701,746,7173,22180,38745,16565
1629,910,404,258,4300,581,8796,Baja,32,2022-03-31,160,167,788,8409,9584,1175
6090,4953,3349,1918,9805,4817,67886,Alta,33,2022-03-31,6133,4760,19860,41825,87746,45921
2437,1747,1113,552,3756,1110,18334,Media-Baja,34,2022-03-31,259,556,5163,11530,23497,11967
2801,1875,1179,507,5060,1107,16759,Media-Baja,35,2022-03-31,325,505,5178,13359,21937,8578
2788,1697,918,611,4046,1382,17022,Media-Baja,36,2022-03-31,280,576,5030,12298,22052,9754
2777,1434,1182,652,4943,1429,17306,Media-Baja,37,2022-03-31,300,541,5455,13258,22761,9503
2412,1831,1018,480,5643,1484,16751,Media-Baja,38,2022-03-31,313,509,5023,13690,21774,8084
6980,4788,3302,2180,9061,4252,84311,Alta,39,2022-03-31,5417,5184,17615,41164,101926,60762
5257,3521,3974,1893,10086,4716,79511,Alta,40,2022-03-31,5204,5833,17623,40484,97134,56650
5820,4518,3284,2139,11582,4525,76273,Alta,41,2022-03-31,5740,5578,17535,43186,93808,50622
4390,2840,2254,1320,5848,2594,33804,Media-Alta,42,2022-03-31,544,781,8255,20571,42059,21488
6171,4525,3468,2106,8410,4215,89954,Alta,43,2022-03-31,4987,4622,18096,38504,108050,69546
7079,4833,4394,1813,9563,4734,74129,Alta,44,2022-03-31,5588,4790,20925,42794,95054,52260
3842,3045,2006,998,6568,2879,33467,Media-Alta,45,2022-03-31,608,842,8214,20788,41681,20893
3993,3131,2070,1419,5939,2773,31387,Media-Alta,46,2022-03-31,595,845,7594,20765,38981,18216
2648,1666,1151,527,4745,1576,16801,Media-Baja,47,2022-03-31,341,534,4544,13188,21345,8157
2559,1584,1215,585,4461,1243,16280,Media-Baja,48,2022-03-31,355,467,5609,12469,21889,9420
3014,1932,892,455,5796,1680,17650,Media-Baja,49,2022-03-31,304,454,4955,14527,22605,8078
2975,1988,985,537,5597,1407,18759,Media-Baja,50,2022-03-31,306,468,4588,14263,23347,9084
1469,831,344,217,3765,646,10044,Baja,51,2022-03-31,183,202,910,7657,10954,3297
4174,3385,2103,959,5424,2824,37528,Media-Alta,52,2022-03-31,533,789,7295,20191,44823,24632
1457,946,378,198,3820,720,9331,Baja,53,2022-03-31,153,166,792,7838,10123,2285
4640,3018,2452,1223,7685,2429,34032,Media-Alta,54,2022-03-31,649,892,7569,22988,41601,18613
2886,1726,1059,598,4383,1464,18654,Media-Baja,55,2022-03-31,328,557,5454,13001,24108,11107
1474,754,383,262,3959,680,9481,Baja,56,2022-03-31,153,169,938,7834,10419,2585
2850,1914,1163,483,4632,1116,16470,Media-Baja,57,2022-03-31,305,582,4247,13045,20717,7672
2629,2087,1064,549,5143,1417,18384,Media-Baja,58,2022-03-31,340,601,5813,13830,24197,10367
3525,2815,2318,1053,5506,2830,35601,Media-Alta,59,2022-03-31,608,713,8731,19368,44332,24964
2777,1648,1167,761,5133,1342,16640,Media-Baja,60,2022-03-31,296,631,4546,13755,21186,7431
2286,1726,1370,679,4997,1282,15910,Media-Baja,61,2022-03-31,292,566,5038,13198,20948,7750
3777,3355,2177,1221,6426,2624,29482,Media-Alta,62,2022-03-31,582,960,7316,21122,36798,15676
2826,1762,1185,578,5938,1478,16093,Media-Baja,63,2022-03-31,282,553,5845,14602,21938,7336
4112,2977,1939,1020,5797,3059,27281,Media-Alta,64,2022-03-31,567,827,7995,20298,35276,14978
5212,3183,2671,1077,7571,2245,34939,Media-Alta,65,2022-03-31,558,966,8846,23483,43785,20302
3806,3372,2225,1128,5481,3147,35243,Media-Alta,66,2022-03-31,592,883,7985,20634,43228,22594
4822,3559,2513,1180,6968,2581,31859,Media-Alta,67,2022-03-31,475,891,7642,22989,39501,16512
1376,811,377,230,4473,721,10291,Baja,69,2022-03-31,166,157,964,8311,11255,2944
2810,1951,1265,565,4767,1597,14945,Media-Baja,70,2022-03-31,316,627,5624,13898,20569,6671
5808,4401,3588,2237,8645,3799,71830,Alta,71,2022-03-31,5015,4476,15715,37969,87545,49576
1426,982,378,234,3803,721,9644,Baja,72,2022-03-31,190,168,719,7902,10363,2461
1551,835,479,237,4226,687,9493,Baja,73,2022-03-31,186,156,753,8357,10246,1889
2707,1547,1220,579,5045,977,16216,Media-Baja,74,2022-03-31,279,616,5263,12970,21479,8509
4533,2481,2412,922,6584,3102,31939,Media-Alta,75,2022-03-31,619,967,8627,21620,40566,18946
3033,1808,1125,519,4680,1216,16272,Media-Baja,76,2022-03-31,290,553,4967,13224,21239,8015
2911,1692,1118,579,5692,1602,15781,Media-Baja,77,2022-03-31,267,543,4959,14404,20740,6336
3807,3477,2475,1036,6610,2679,32078,Media-Alta,79,2022-03-31,542,852,8499,21478,40577,19099
4399,2878,1942,1320,5465,2649,36968,Media-Alta,80,2022-03-31,527,918,8334,20098,45302,25204
2832,1751,1091,499,5112,1465,18607,Media-Baja,81,2022-03-31,321,520,3587,13591,22194,8603
1238,984,404,251,3965,585,10083,Baja,82,2022-03-31,181,164,796,7772,10879,3107
1512,949,458,238,3302,619,9416,Baja,83,2022-03-31,158,181,911,7417,10327,2910
2820,1559,1175,557,5187,1492,16023,Media-Baja,84,2022-03-31,233,559,5085,13582,21108,7526
1346,847,494,221,4014,798,8581,Baja,85,2022-03-31,199,162,960,8081,9541,1460
1491,649,370,210,4259,774,9012,Baja,86,2022-03-31,190,133,785,8076,9797,1721
3361,1646,1091,558,5062,1510,14884,Media-Baja,87,2022-03-31,282,522,5152,14032,20036,6004
2609,1973,1113,494,5934,1408,15971,Media-Baja,88,2022-03-31,241,529,5331,14301,21302,7001
1276,989,356,229,3658,835,9243,Baja,89,2022-03-31,165,169,863,7677,10106,2429
1324,917,363,258,3795,641,7686,Baja,90,2022-03-31,144,169,898,7611,8584,973
2928,1385,1222,562,5233,1136,16199,Media-Baja,91,2022-03-31,300,675,5164,13441,21363,7922
3934,3271,2636,1334,6288,2928,34633,Media-Alta,92,2022-03-31,541,836,8267,21768,42900,21132
2871,1890,1151,640,6293,1393,16624,Media-Baja,93,2022-03-31,303,519,5221,15060,21845,6785
2744,1718,1301,607,5080,1489,15374,Media-Baja,94,2022-03-31,280,546,5678,13765,21052,7287
3655,1632,1131,617,5229,1680,19724,Media-Baja,95,2022-03-31,331,567,4660,14842,24384,9542
1562,879,411,257,4432,757,9205,Baja,96,2022-03-31,160,159,843,8617,10048,1431
2947,1722,1286,485,4199,1385,16069,Media-Baja,97,2022-03-31,311,469,4540,12804,20609,7805
1311,803,389,199,3507,635,9710,Baja,98,2022-03-31,184,158,745,7186,10455,3269
3021,1604,1090,561,5376,1414,16847,Media-Baja,99,2022-03-31,370,474,5610,13910,22457,8547
4250,3046,2063,1146,6507,2700,27363,Media-Alta,0,2022-04-30,617,786,8029,21115,35392,14277
1270,917,439,192,3972,647,7952,Baja,1,2022-04-30,181,178,1031,7796,8983,1187
2980,1475,943,592,5394,1319,15615,Media-Baja,2,2022-04-30,282,634,4965,13619,20580,6961
4551,2846,2433,1151,5119,3234,35535,Media-Alta,3,2022-04-30,529,725,8151,20588,43686,23098
1460,897,340,191,3520,650,10791,Baja,4,2022-04-30,170,162,898,7390,11689,4299
2959,1837,1162,541,4613,1383,16472,Media-Baja,5,2022-04-30,274,620,4808,13389,21280,7891
2658,1659,1023,496,5327,1793,17223,Media-Baja,6,2022-04-30,242,609,4977,13807,22200,8393
4926,4285,3210,2424,9345,4981,92260,Alta,7,2022-04-30,6351,5086,16358,40608,108618,68010
4654,2824,2780,1200,8234,2924,35398,Media-Alta,8,2022-04-30,627,840,8134,24083,43532,19449
4923,3549,3526,2202,9029,4857,84440,Alta,9,2022-04-30,4967,4569,19812,37622,104252,66630
2866,1590,1313,642,5680,1448,18711,Media-Baja,10,2022-04-30,300,586,4585,14425,23296,8871
2503,1717,1301,532,5511,1474,15935,Media-Baja,11,2022-04-30,266,573,5472,13877,21407,7530
3153,1725,1162,662,5775,1510,17304,Media-Baja,12,2022-04-30,291,518,5056,14796,22360,7564
4275,3724,2420,1122,5934,2905,37385,Media-Alta,13,2022-04-30,625,820,7638,21825,45023,23198
2976,1749,1040,521,5873,1436,14888,Media-Baja,14,2022-04-30,266,494,6432,14355,21320,6965
1497,646,431,217,4406,691,8091,Baja,15,2022-04-30,172,172,658,8232,8749,517
2610,1661,1221,642,5885,1482,15685,Media-Baja,16,2022-04-30,300,546,5821,14347,21506,7159
2975,1761,1032,592,4899,1255,16963,Media-Baja,17,2022-04-30,311,560,5057,13385,22020,8635
3202,1553,976,509,4615,1213,19084,Media-Baja,18,2022-04-30,288,550,3708,12906,22792,9886
3096,1598,1076,560,5929,1435,16898,Media-Baja,19,2022-04-30,285,592,5328,14571,22226,7655
2772,1530,935,576,5071,1409,19243,Media-Baja,20,2022-04-30,292,597,4882,13182,24125,10943
4071,3083,2225,1293,6167,3212,31753,Media-Alta,21,2022-04-30,608,884,7266,21543,39019,17476
5040,4057,2267,1058,5282,3570,38666,Media-Alta,22,2022-04-30,693,834,7665,22801,46331,23530
2535,1534,1165,558,5102,1783,18648,Media-Baja,23,2022-04-30,287,483,4896,13447,23544,10097
1534,905,407,185,3483,601,9328,Baja,24,2022-04-30,175,161,914,7451,10242,2791
6215,5044,4202,1780,10160,5324,68636,Alta,25,2022-04-30,5560,5087,18203,43372,86839,43467
4565,3403,2641,1312,6396,2964,30928,Media-Alta,26,2022-04-30,647,901,8464,22829,39392,16563
1547,884,396,246,3431,705,8860,Baja,27,2022-04-30,164,169,808,7542,9668,2126
4430,3125,2185,1088,6342,3034,42247,Media-Alta,28,2022-04-30,616,908,8047,21728,50294,28566
1303,775,390,247,4073,753,9664,Baja,29,2022-04-30,226,182,774,7949,10438,2489
2714,1598,1174,485,4431,1656,17689,Media-Baja,30,2022-04-30,292,551,5085,12901,22774,9873
3720,3965,2163,1253,6844,2788,31572,Media-Alta,31,2022-04-30,644,933,8059,22310,39631,17321
1629,910,404,258,4300,581,8796,Baja,32,2022-04-30,153,136,895,8371,9691,1320
6090,4953,3349,1918,9805,4817,67886,Alta,33,2022-04-30,5146,5018,18395,41096,86281,45185
2437,1747,1113,552,3756,1110,18334,Media-Baja,34,2022-04-30,247,516,4398,11478,22732,11254
2801,1875,1179,507,5060,1107,16759,Media-Baja,35,2022-04-30,278,677,5177,13484,21936,8452
2788,1697,918,611,4046,1382,17022,Media-Baja,36,2022-04-30,282,630,5194,12354,22216,9862
2777,1434,1182,652,4943,1429,17306,Media-Baja,37,2022-04-30,308,549,4442,13274,21748,8474
2412,1831,1018,480,5643,1484,16751,Media-Baja,38,2022-04-30,319,638,5195,13825,21946,8121
6980,4788,3302,2180,9061,4252,84311,Alta,39,2022-04-30,5160,5529,17288,41252,101599,60347
5257,3521,3974,1893,10086,4716,79511,Alta,40,2022-04-30,6109,5628,18601,41184,98112,56928
5820,4518,3284,2139,11582,4525,76273,Alta,41,2022-04-30,5309,4917,14409,42094,90682,48588
4390,2840,2254,1320,5848,2594,33804,Media-Alta,42,2022-04-30,561,835,8207,20642,42011,21369
6171,4525,3468,2106,8410,4215,89954,Alta,43,2022-04-30,6216,4778,20000,39889,109954,70065
7079,4833,4394,1813,9563,4734,74129,Alta,44,2022-04-30,5300,4701,16479,42417,90608,48191
3842,3045,2006,998,6568,2879,33467,Media-Alta,45,2022-04-30,499,807,9048,20644,42515,21871
3993,3131,2070,1419,5939,2773,31387,Media-Alta,46,2022-04-30,589,827,8846,20741,40233,19492
2648,1666,1151,527,4745,1576,16801,Media-Baja,47,2022-04-30,312,579,4683,13204,21484,8280
2559,1584,1215,585,4461,1243,16280,Media-Baja,48,2022-04-30,301,650,5181,12598,21461,8863
3014,1932,892,455,5796,1680,17650,Media-Baja,49,2022-04-30,281,594,4923,14644,22573,7929
2975,1988,985,537,5597,1407,18759,Media-Baja,50,2022-04-30,226,562,4589,14277,23348,9071
1469,831,344,217,3765,646,10044,Baja,51,2022-04-30,185,173,756,7630,10800,3170
4174,3385,2103,959,5424,2824,37528,Media-Alta,52,2022-04-30,505,835,6922,20209,44450,24241
1457,946,378,198,3820,720,9331,Baja,53,2022-04-30,160,199,722,7878,10053,2175
4640,3018,2452,1223,7685,2429,34032,Media-Alta,54,2022-04-30,592,941,8807,22980,42839,19859
2886,1726,1059,598,4383,1464,18654,Media-Baja,55,2022-04-30,256,625,5475,12997,24129,11132
1474,754,383,262,3959,680,9481,Baja,56,2022-04-30,175,181,904,7868,10385,2517
2850,1914,1163,483,4632,1116,16470,Media-Baja,57,2022-04-30,238,589,4618,12985,21088,8103
2629,2087,1064,549,5143,1417,18384,Media-Baja,58,2022-04-30,246,558,5261,13693,23645,9952
3525,2815,2318,1053,5506,2830,35601,Media-Alta,59,2022-04-30,532,796,7832,19375,43433,24058
2777,1648,1167,761,5133,1342,16640,Media-Baja,60,2022-04-30,299,570,5669,13697,22309,8612
2286,1726,1370,679,4997,1282,15910,Media-Baja,61,2022-04-30,279,512,6010,13131,21920,8789
3777,3355,2177,1221,6426,2624,29482,Media-Alta,62,2022-04-30,585,876,8294,21041,37776,16735
2826,1762,1185,578,5938,1478,16093,Media-Baja,63,2022-04-30,266,573,5342,14606,21435,6829
4112,2977,1939,1020,5797,3059,27281,Media-Alta,64,2022-04-30,592,951,7372,20447,34653,14206
5212,3183,2671,1077,7571,2245,34939,Media-Alta,65,2022-04-30,602,747,6994,23308,41933,18625
3806,3372,2225,1128,5481,3147,35243,Media-Alta,66,2022-04-30,543,741,9370,20443,44613,24170
4822,3559,2513,1180,6968,2581,31859,Media-Alta,67,2022-04-30,529,820,7245,22972,39104,16132
1376,811,377,230,4473,721,10291,Baja,69,2022-04-30,175,182,1006,8345,11297,2952
2810,1951,1265,565,4767,1597,14945,Media-Baja,70,2022-04-30,293,575,4844,13823,19789,5966
5808,4401,3588,2237,8645,3799,71830,Alta,71,2022-04-30,5105,5239,16003,38822,87833,49011
1426,982,378,234,3803,721,9644,Baja,72,2022-04-30,211,178,808,7933,10452,2519
1551,835,479,237,4226,687,9493,Baja,73,2022-04-30,169,167,876,8351,10369,2018
2707,1547,1220,579,5045,977,16216,Media-Baja,74,2022-04-30,271,617,4972,12963,21188,8225
4533,2481,2412,922,6584,3102,31939,Media-Alta,75,2022-04-30,608,868,8036,21510,39975,18465
3033,1808,1125,519,4680,1216,16272,Media-Baja,76,2022-04-30,276,462,4909,13119,21181,8062
2911,1692,1118,579,5692,1602,15781,Media-Baja,77,2022-04-30,271,571,5172,14436,20953,6517
3807,3477,2475,1036,6610,2679,32078,Media-Alta,79,2022-04-30,510,855,7575,21449,39653,18204
4399,2878,1942,1320,5465,2649,36968,Media-Alta,80,2022-04-30,595,732,7836,19980,44804,24824
2832,1751,1091,499,5112,1465,18607,Media-Baja,81,2022-04-30,268,674,4243,13692,22850,9158
1238,984,404,251,3965,585,10083,Baja,82,2022-04-30,200,164,911,7791,10994,3203
1512,949,458,238,3302,619,9416,Baja,83,2022-04-30,160,149,893,7387,10309,2922
2820,1559,1175,557,5187,1492,16023,Media-Baja,84,2022-04-30,247,567,4589,13604,20612,7008
1346,847,494,221,4014,798,8581,Baja,85,2022-04-30,203,165,836,8088,9417,1329
1491,649,370,210,4259,774,9012,Baja,86,2022-04-30,161,177,975,8091,9987,1896
3361,1646,1091,558,5062,1510,14884,Media-Baja,87,2022-04-30,285,478,5432,13991,20316,6325
2609,1973,1113,494,5934,1408,15971,Media-Baja,88,2022-04-30,314,532,4803,14377,20774,6397
1276,989,356,229,3658,835,9243,Baja,89,2022-04-30,146,170,838,7659,10081,2422
1324,917,363,258,3795,641,7686,Baja,90,2022-04-30,188,160,984,7646,8670,1024
2928,1385,1222,562,5233,1136,16199,Media-Baja,91,2022-04-30,295,617,4344,13378,20543,7165
3934,3271,2636,1334,6288,2928,34633,Media-Alta,92,2022-04-30,484,787,6627,21662,41260,19598
2871,1890,1151,640,6293,1393,16624,Media-Baja,93,2022-04-30,289,558,5314,15085,21938,6853
2744,1718,1301,607,5080,1489,15374,Media-Baja,94,2022-04-30,325,591,4452,13855,19826,5971
3655,1632,1131,617,5229,1680,19724,Media-Baja,95,2022-04-30,238,574,5467,14756,25191,10435
1562,879,411,257,4432,757,9205,Baja,96,2022-04-30,141,160,877,8599,10082,1483
2947,1722,1286,485,4199,1385,16069,Media-Baja,97,2022-04-30,331,605,3969,12960,20038,7078
1311,803,389,199,3507,635,9710,Baja,98,2022-04-30,169,185,994,7198,10704,3506
3021,1604,1090,561,5376,1414,16847,Media-Baja,99,2022-04-30,265,568,4226,13899,21073,7174
4250,3046,2063,1146,6507,2700,27363,Media-Alta,0,2022-05-31,500,790,7437,21002,34800,13798
1270,917,439,192,3972,647,7952,Baja,1,2022-05-31,178,150,842,7765,8794,1029
2980,1475,943,592,5394,1319,15615,Media-Baja,2,2022-05-31,323,550,5154,13576,20769,7193
4551,2846,2433,1151,5119,3234,35535,Media-Alta,3,2022-05-31,724,798,7718,20856,43253,22397
1460,897,340,191,3520,650,10791,Baja,4,2022-05-31,189,156,896,7403,11687,4284
2959,1837,1162,541,4613,1383,16472,Media-Baja,5,2022-05-31,263,573,4805,13331,21277,7946
2658,1659,1023,496,5327,1793,17223,Media-Baja,6,2022-05-31,316,536,4517,13808,21740,7932
4926,4285,3210,2424,9345,4981,92260,Alta,7,2022-05-31,5534,5685,15289,40390,107549,67159
4654,2824,2780,1200,8234,2924,35398,Media-Alta,8,2022-05-31,570,834,8020,24020,43418,19398
4923,3549,3526,2202,9029,4857,84440,Alta,9,2022-05-31,5953,5291,21721,39330,106161,66831
2866,1590,1313,642,5680,1448,18711,Media-Baja,10,2022-05-31,280,508,4490,14327,23201,8874
2503,1717,1301,532,5511,1474,15935,Media-Baja,11,2022-05-31,312,687,5189,14037,21124,7087
3153,1725,1162,662,5775,1510,17304,Media-Baja,12,2022-05-31,320,634,4851,14941,22155,7214
4275,3724,2420,1122,5934,2905,37385,Media-Alta,13,2022-05-31,622,829,8929,21831,46314,24483
2976,1749,1040,521,5873,1436,14888,Media-Baja,14,2022-05-31,221,707,4977,14523,19865,5342
1497,646,431,217,4406,691,8091,Baja,15,2022-05-31,186,169,763,8243,8854,611
2610,1661,1221,642,5885,1482,15685,Media-Baja,16,2022-05-31,272,486,5092,14259,20777,6518
2975,1761,1032,592,4899,1255,16963,Media-Baja,17,2022-05-31,272,623,5245,13409,22208,8799
3202,1553,976,509,4615,1213,19084,Media-Baja,18,2022-05-31,227,540,4750,12835,23834,10999
3096,1598,1076,560,5929,1435,16898,Media-Baja,19,2022-05-31,257,592,5260,14543,22158,7615
2772,1530,935,576,5071,1409,19243,Media-Baja,20,2022-05-31,303,512,5037,13108,24280,11172
4071,3083,2225,1293,6167,3212,31753,Media-Alta,21,2022-05-31,542,795,7652,21388,39405,18017
5040,4057,2267,1058,5282,3570,38666,Media-Alta,22,2022-05-31,680,737,8083,22691,46749,24058
2535,1534,1165,558,5102,1783,18648,Media-Baja,23,2022-05-31,260,607,5262,13544,23910,10366
1534,905,407,185,3483,601,9328,Baja,24,2022-05-31,177,157,717,7449,10045,2596
6215,5044,4202,1780,10160,5324,68636,Alta,25,2022-05-31,6429,4416,19071,43570,87707,44137
4565,3403,2641,1312,6396,2964,30928,Media-Alta,26,2022-05-31,541,815,8767,22637,39695,17058
1547,884,396,246,3431,705,8860,Baja,27,2022-05-31,160,188,908,7557,9768,2211
4430,3125,2185,1088,6342,3034,42247,Media-Alta,28,2022-05-31,663,764,8090,21631,50337,28706
1303,775,390,247,4073,753,9664,Baja,29,2022-05-31,164,118,909,7823,10573,2750
2714,1598,1174,485,4431,1656,17689,Media-Baja,30,2022-05-31,308,641,4693,13007,22382,9375
3720,3965,2163,1253,6844,2788,31572,Media-Alta,31,2022-05-31,635,805,8571,22173,40143,17970
1629,910,404,258,4300,581,8796,Baja,32,2022-05-31,162,172,698,8416,9494,1078
6090,4953,3349,1918,9805,4817,67886,Alta,33,2022-05-31,4629,4945,14622,40506,82508,42002
2437,1747,1113,552,3756,1110,18334,Media-Baja,34,2022-05-31,264,497,5094,11476,23428,11952
2801,1875,1179,507,5060,1107,16759,Media-Baja,35,2022-05-31,303,474,4195,13306,20954,7648
2788,1697,918,611,4046,1382,17022,Media-Baja,36,2022-05-31,284,559,5386,12285,22408,10123
2777,1434,1182,652,4943,1429,17306,Media-Baja,37,2022-05-31,254,603,5847,13274,23153,9879
2412,1831,1018,480,5643,1484,16751,Media-Baja,38,2022-05-31,264,516,4956,13648,21707,8059
6980,4788,3302,2180,9061,4252,84311,Alta,39,2022-05-31,6279,5683,20964,42525,105275,62750
5257,3521,3974,1893,10086,4716,79511,Alta,40,2022-05-31,6757,5154,17839,41358,97350,55992
5820,4518,3284,2139,11582,4525,76273,Alta,41,2022-05-31,6191,5420,17522,43479,93795,50316
4390,2840,2254,1320,5848,2594,33804,Media-Alta,42,2022-05-31,570,934,8569,20750,42373,21623
6171,4525,3468,2106,8410,4215,89954,Alta,43,2022-05-31,6404,4798,13591,40097,103545,63448
7079,4833,4394,1813,9563,4734,74129,Alta,44,2022-05-31,5353,5121,15900,42890,90029,47139
3842,3045,2006,998,6568,2879,33467,Media-Alta,45,2022-05-31,574,880,7157,20792,40624,19832
3993,3131,2070,1419,5939,2773,31387,Media-Alta,46,2022-05-31,581,865,8035,20771,39422,18651
2648,1666,1151,527,4745,1576,16801,Media-Baja,47,2022-05-31,300,480,3943,13093,20744,7651
2559,1584,1215,585,4461,1243,16280,Media-Baja,48,2022-05-31,327,610,4737,12584,21017,8433
3014,1932,892,455,5796,1680,17650,Media-Baja,49,2022-05-31,300,496,5235,14565,22885,8320
2975,1988,985,537,5597,1407,18759,Media-Baja,50,2022-05-31,314,590,5245,14393,24004,9611
1469,831,344,217,3765,646,10044,Baja,51,2022-05-31,170,159,826,7601,10870,3269
4174,3385,2103,959,5424,2824,37528,Media-Alta,52,2022-05-31,532,916,7303,20317,44831,24514
1457,946,378,198,3820,720,9331,Baja,53,2022-05-31,173,185,711,7877,10042,2165
4640,3018,2452,1223,7685,2429,34032,Media-Alta,54,2022-05-31,530,895,7808,22872,41840,18968
2886,1726,1059,598,4383,1464,18654,Media-Baja,55,2022-05-31,297,578,4195,12991,22849,9858
1474,754,383,262,3959,680,9481,Baja,56,2022-05-31,178,183,1018,7873,10499,2626
2850,1914,1163,483,4632,1116,16470,Media-Baja,57,2022-05-31,252,567,5244,12977,21714,8737
2629,2087,1064,549,5143,1417,18384,Media-Baja,58,2022-05-31,273,535,4362,13697,22746,9049
3525,2815,2318,1053,5506,2830,35601,Media-Alta,59,2022-05-31,599,904,7357,19550,42958,23408
2777,1648,1167,761,5133,1342,16640,Media-Baja,60,2022-05-31,255,524,5494,13607,22134,8527
2286,1726,1370,679,4997,1282,15910,Media-Baja,61,2022-05-31,278,575,5548,13193,21458,8265
3777,3355,2177,1221,6426,2624,29482,Media-Alta,62,2022-05-31,617,832,7180,21029,36662,15633
2826,1762,1185,578,5938,1478,16093,Media-Baja,63,2022-05-31,295,438,4978,14500,21071,6571
4112,2977,1939,1020,5797,3059,27281,Media-Alta,64,2022-05-31,565,666,9383,20135,36664,16529
5212,3183,2671,1077,7571,2245,34939,Media-Alta,65,2022-05-31,564,844,8050,23367,42989,19622
3806,3372,2225,1128,5481,3147,35243,Media-Alta,66,2022-05-31,518,992,7655,20669,42898,22229
4822,3559,2513,1180,6968,2581,31859,Media-Alta,67,2022-05-31,422,885,8631,22930,40490,17560
1376,811,377,230,4473,721,10291,Baja,69,2022-05-31,164,178,932,8330,11223,2893
2810,1951,1265,565,4767,1597,14945,Media-Baja,70,2022-05-31,265,551,5660,13771,20605,6834
5808,4401,3588,2237,8645,3799,71830,Alta,71,2022-05-31,5650,5239,18079,39367,89909,50542
1426,982,378,234,3803,721,9644,Baja,72,2022-05-31,182,169,1040,7895,10684,2789
1551,835,479,237,4226,687,9493,Baja,73,2022-05-31,172,151,790,8338,10283,1945
2707,1547,1220,579,5045,977,16216,Media-Baja,74,2022-05-31,289,578,4838,12942,21054,8112
4533,2481,2412,922,6584,3102,31939,Media-Alta,75,2022-05-31,631,936,7294,21601,39233,17632
3033,1808,1125,519,4680,1216,16272,Media-Baja,76,2022-05-31,254,643,5320,13278,21592,8314
2911,1692,1118,579,5692,1602,15781,Media-Baja,77,2022-05-31,285,469,5248,14348,21029,6681
3807,3477,2475,1036,6610,2679,32078,Media-Alta,79,2022-05-31,502,814,8238,21400,40316,18916
4399,2878,1942,1320,5465,2649,36968,Media-Alta,80,2022-05-31,532,842,6548,20027,43516,23489
2832,1751,1091,499,5112,1465,18607,Media-Baja,81,2022-05-31,272,460,4116,13482,22723,9241
1238,984,404,251,3965,585,10083,Baja,82,2022-05-31,142,144,806,7713,10889,3176
1512,949,458,238,3302,619,9416,Baja,83,2022-05-31,141,215,768,7434,10184,2750
2820,1559,1175,557,5187,1492,16023,Media-Baja,84,2022-05-31,304,549,4924,13643,20947,7304
1346,847,494,221,4014,798,8581,Baja,85,2022-05-31,170,174,885,8064,9466,1402
1491,649,370,210,4259,774,9012,Baja,86,2022-05-31,178,173,840,8104,9852,1748
3361,1646,1091,558,5062,1510,14884,Media-Baja,87,2022-05-31,314,518,5838,14060,20722,6662
2609,1973,1113,494,5934,1408,15971,Media-Baja,88,2022-05-31,317,521,4904,14369,20875,6506
1276,989,356,229,3658,835,9243,Baja,89,2022-05-31,177,125,777,7645,10020,2375
1324,917,363,258,3795,641,7686,Baja,90,2022-05-31,166,160,939,7624,8625,1001
2928,1385,1222,562,5233,1136,16199,Media-Baja,91,2022-05-31,270,642,5142,13378,21341,7963
3934,3271,2636,1334,6288,2928,34633,Media-Alta,92,2022-05-31,504,913,7591,21808,42224,20416
2871,1890,1151,640,6293,1393,16624,Media-Baja,93,2022-05-31,285,511,4838,15034,21462,6428
2744,1718,1301,607,5080,1489,15374,Media-Baja,94,2022-05-31,301,581,5084,13821,20458,6637
3655,1632,1131,617,5229,1680,19724,Media-Baja,95,2022-05-31,308,522,3956,14774,23680,8906
1562,879,411,257,4432,757,9205,Baja,96,2022-05-31,200,152,790,8650,9995,1345
2947,1722,1286,485,4199,1385,16069,Media-Baja,97,2022-05-31,293,541,4987,12858,21056,8198
1311,803,389,199,3507,635,9710,Baja,98,2022-05-31,170,174,714,7188,10424,3236
3021,1604,1090,561,5376,1414,16847,Media-Baja,99,2022-05-31,258,634,5059,13958,21906,7948
4250,3046,2063,1146,6507,2700,27363,Media-Alta,0,2022-06-30,652,1022,9270,21386,36633,15247
1270,917,439,192,3972,647,7952,Baja,1,2022-06-30,181,167,884,7785,8836,1051
2980,1475,943,592,5394,1319,15615,Media-Baja,2,2022-06-30,274,622,4992,13599,20607,7008
4551,2846,2433,1151,5119,3234,35535,Media-Alta,3,2022-06-30,597,823,8452,20754,43987,23233
1460,897,340,191,3520,650,10791,Baja,4,2022-06-30,149,161,900,7368,11691,4323
2959,1837,1162,541,4613,1383,16472,Media-Baja,5,2022-06-30,322,512,4827,13329,21299,7970
2658,1659,1023,496,5327,1793,17223,Media-Baja,6,2022-06-30,319,537,5461,13812,22684,8872
4926,4285,3210,2424,9345,4981,92260,Alta,7,2022-06-30,5874,5512,19043,40557,111303,70746
4654,2824,2780,1200,8234,2924,35398,Media-Alta,8,2022-06-30,620,794,8073,24030,43471,19441
4923,3549,3526,2202,9029,4857,84440,Alta,9,2022-06-30,6130,5552,17337,39768,101777,62009
2866,1590,1313,642,5680,1448,18711,Media-Baja,10,2022-06-30,249,587,4888,14375,23599,9224
2503,1717,1301,532,5511,1474,15935,Media-Baja,11,2022-06-30,290,527,5212,13855,21147,7292
3153,1725,1162,662,5775,1510,17304,Media-Baja,12,2022-06-30,254,545,5288,14786,22592,7806
4275,3724,2420,1122,5934,2905,37385,Media-Alta,13,2022-06-30,606,887,7053,21873,44438,22565
2976,1749,1040,521,5873,1436,14888,Media-Baja,14,2022-06-30,240,584,3898,14419,18786,4367
1497,646,431,217,4406,691,8091,Baja,15,2022-06-30,192,178,781,8258,8872,614
2610,1661,1221,642,5885,1482,15685,Media-Baja,16,2022-06-30,207,598,4558,14306,20243,5937
2975,1761,1032,592,4899,1255,16963,Media-Baja,17,2022-06-30,258,610,4679,13382,21642,8260
3202,1553,976,509,4615,1213,19084,Media-Baja,18,2022-06-30,217,522,5755,12807,24839,12032
3096,1598,1076,560,5929,1435,16898,Media-Baja,19,2022-06-30,259,601,4890,14554,21788,7234
2772,1530,935,576,5071,1409,19243,Media-Baja,20,2022-06-30,216,626,5956,13135,25199,12064
4071,3083,2225,1293,6167,3212,31753,Media-Alta,21,2022-06-30,597,737,7566,21385,39319,17934
5040,4057,2267,1058,5282,3570,38666,Media-Alta,22,2022-06-30,600,883,8096,22757,46762,24005
2535,1534,1165,558,5102,1783,18648,Media-Baja,23,2022-06-30,290,481,5291,13448,23939,10491
1534,905,407,185,3483,601,9328,Baja,24,2022-06-30,162,143,862,7420,10190,2770
6215,5044,4202,1780,10160,5324,68636,Alta,25,2022-06-30,6228,5412,18373,44365,87009,42644
4565,3403,2641,1312,6396,2964,30928,Media-Alta,26,2022-06-30,591,787,7886,22659,38814,16155
1547,884,396,246,3431,705,8860,Baja,27,2022-06-30,169,154,817,7532,9677,2145
4430,3125,2185,1088,6342,3034,42247,Media-Alta,28,2022-06-30,554,777,7257,21535,49504,27969
1303,775,390,247,4073,753,9664,Baja,29,2022-06-30,153,165,922,7859,10586,2727
2714,1598,1174,485,4431,1656,17689,Media-Baja,30,2022-06-30,258,627,4903,12943,22592,9649
3720,3965,2163,1253,6844,2788,31572,Media-Alta,31,2022-06-30,561,794,7234,22088,38806,16718
1629,910,404,258,4300,581,8796,Baja,32,2022-06-30,172,144,888,8398,9684,1286
6090,4953,3349,1918,9805,4817,67886,Alta,33,2022-06-30,5886,5175,17635,41993,85521,43528
2437,1747,1113,552,3756,1110,18334,Media-Baja,34,2022-06-30,249,436,5016,11400,23350,11950
2801,1875,1179,507,5060,1107,16759,Media-Baja,35,2022-06-30,262,594,5332,13385,22091,8706
2788,1697,918,611,4046,1382,17022,Media-Baja,36,2022-06-30,247,603,5384,12292,22406,10114
2777,1434,1182,652,4943,1429,17306,Media-Baja,37,2022-06-30,308,529,5691,13254,22997,9743
2412,1831,1018,480,5643,1484,16751,Media-Baja,38,2022-06-30,324,671,5336,13863,22087,8224
6980,4788,3302,2180,9061,4252,84311,Alta,39,2022-06-30,5948,5183,16548,41694,100859,59165
5257,3521,3974,1893,10086,4716,79511,Alta,40,2022-06-30,6148,4933,16143,40528,95654,55126
5820,4518,3284,2139,11582,4525,76273,Alta,41,2022-06-30,5372,5484,18489,42724,94762,52038
4390,2840,2254,1320,5848,2594,33804,Media-Alta,42,2022-06-30,562,740,8847,20548,42651,22103
6171,4525,3468,2106,8410,4215,89954,Alta,43,2022-06-30,6731,5929,19453,41555,109407,67852
7079,4833,4394,1813,9563,4734,74129,Alta,44,2022-06-30,5067,5356,15287,42839,89416,46577
3842,3045,2006,998,6568,2879,33467,Media-Alta,45,2022-06-30,536,772,8557,20646,42024,21378
3993,3131,2070,1419,5939,2773,31387,Media-Alta,46,2022-06-30,656,945,8033,20926,39420,18494
2648,1666,1151,527,4745,1576,16801,Media-Baja,47,2022-06-30,312,669,4775,13294,21576,8282
2559,1584,1215,585,4461,1243,16280,Media-Baja,48,2022-06-30,307,614,5158,12568,21438,8870
3014,1932,892,455,5796,1680,17650,Media-Baja,49,2022-06-30,254,551,5364,14574,23014,8440
2975,1988,985,537,5597,1407,18759,Media-Baja,50,2022-06-30,276,564,5391,14329,24150,9821
1469,831,344,217,3765,646,10044,Baja,51,2022-06-30,160,164,793,7596,10837,3241
4174,3385,2103,959,5424,2824,37528,Media-Alta,52,2022-06-30,504,902,7142,20275,44670,24395
1457,946,378,198,3820,720,9331,Baja,53,2022-06-30,161,156,748,7836,10079,2243
4640,3018,2452,1223,7685,2429,34032,Media-Alta,54,2022-06-30,532,1002,9102,22981,43134,20153
2886,1726,1059,598,4383,1464,18654,Media-Baja,55,2022-06-30,259,505,5111,12880,23765,10885
1474,754,383,262,3959,680,9481,Baja,56,2022-06-30,154,175,771,7841,10252,2411
2850,1914,1163,483,4632,1116,16470,Media-Baja,57,2022-06-30,275,592,5190,13025,21660,8635
2629,2087,1064,549,5143,1417,18384,Media-Baja,58,2022-06-30,263,578,5168,13730,23552,9822
3525,2815,2318,1053,5506,2830,35601,Media-Alta,59,2022-06-30,548,899,8812,19494,44413,24919
2777,1648,1167,761,5133,1342,16640,Media-Baja,60,2022-06-30,303,608,4873,13739,21513,7774
2286,1726,1370,679,4997,1282,15910,Media-Baja,61,2022-06-30,258,549,5581,13147,21491,8344
3777,3355,2177,1221,6426,2624,29482,Media-Alta,62,2022-06-30,567,720,7796,20867,37278,16411
2826,1762,1185,578,5938,1478,16093,Media-Baja,63,2022-06-30,322,524,5393,14613,21486,6873
4112,2977,1939,1020,5797,3059,27281,Media-Alta,64,2022-06-30,576,856,6614,20336,33895,13559
5212,3183,2671,1077,7571,2245,34939,Media-Alta,65,2022-06-30,597,891,7473,23447,42412,18965
3806,3372,2225,1128,5481,3147,35243,Media-Alta,66,2022-06-30,638,691,9745,20488,44988,24500
4822,3559,2513,1180,6968,2581,31859,Media-Alta,67,2022-06-30,590,959,8444,23172,40303,17131
1376,811,377,230,4473,721,10291,Baja,69,2022-06-30,175,167,881,8330,11172,2842
2810,1951,1265,565,4767,1597,14945,Media-Baja,70,2022-06-30,298,544,5632,13797,20577,6780
5808,4401,3588,2237,8645,3799,71830,Alta,71,2022-06-30,5494,4586,17663,38558,89493,50935
1426,982,378,234,3803,721,9644,Baja,72,2022-06-30,181,159,667,7884,10311,2427
1551,835,479,237,4226,687,9493,Baja,73,2022-06-30,139,159,910,8313,10403,2090
2707,1547,1220,579,5045,977,16216,Media-Baja,74,2022-06-30,280,520,4679,12875,20895,8020
4533,2481,2412,922,6584,3102,31939,Media-Alta,75,2022-06-30,483,734,8444,21251,40383,19132
3033,1808,1125,519,4680,1216,16272,Media-Baja,76,2022-06-30,296,586,5300,13263,21572,8309
2911,1692,1118,579,5692,1602,15781,Media-Baja,77,2022-06-30,278,608,4569,14480,20350,5870
3807,3477,2475,1036,6610,2679,32078,Media-Alta,79,2022-06-30,549,946,9128,21579,41206,19627
4399,2878,1942,1320,5465,2649,36968,Media-Alta,80,2022-06-30,685,985,8396,20323,45364,25041
2832,1751,1091,499,5112,1465,18607,Media-Baja,81,2022-06-30,344,633,4992,13727,23599,9872
1238,984,404,251,3965,585,10083,Baja,82,2022-06-30,200,160,1115,7787,11198,3411
1512,949,458,238,3302,619,9416,Baja,83,2022-06-30,165,141,718,7384,10134,2750
2820,1559,1175,557,5187,1492,16023,Media-Baja,84,2022-06-30,255,533,4876,13578,20899,7321
1346,847,494,221,4014,798,8581,Baja,85,2022-06-30,174,166,939,8060,9520,1460
1491,649,370,210,4259,774,9012,Baja,86,2022-06-30,175,158,936,8086,9948,1862
3361,1646,1091,558,5062,1510,14884,Media-Baja,87,2022-06-30,282,626,5125,14136,20009,5873
2609,1973,1113,494,5934,1408,15971,Media-Baja,88,2022-06-30,305,632,4816,14468,20787,6319
1276,989,356,229,3658,835,9243,Baja,89,2022-06-30,170,178,885,7691,10128,2437
1324,917,363,258,3795,641,7686,Baja,90,2022-06-30,173,161,800,7632,8486,854
2928,1385,1222,562,5233,1136,16199,Media-Baja,91,2022-06-30,278,562,5144,13306,21343,8037
3934,3271,2636,1334,6288,2928,34633,Media-Alta,92,2022-06-30,560,876,8454,21827,43087,21260
2871,1890,1151,640,6293,1393,16624,Media-Baja,93,2022-06-30,248,511,4526,14997,21150,6153
2744,1718,1301,607,5080,1489,15374,Media-Baja,94,2022-06-30,299,550,4855,13788,20229,6441
3655,1632,1131,617,5229,1680,19724,Media-Baja,95,2022-06-30,274,607,4674,14825,24398,9573
1562,879,411,257,4432,757,9205,Baja,96,2022-06-30,151,173,795,8622,10000,1378
2947,1722,1286,485,4199,1385,16069,Media-Baja,97,2022-06-30,319,574,4188,12917,20257,7340
1311,803,389,199,3507,635,9710,Baja,98,2022-06-30,199,167,702,7210,10412,3202
3021,1604,1090,561,5376,1414,16847,Media-Baja,99,2022-06-30,275,607,4898,13948,21745,7797
4250,3046,2063,1146,6507,2700,27363,Media-Alta,0,2022-07-31,615,865,8193,21192,35556,14364
1270,917,439,192,3972,647,7952,Baja,1,2022-07-31,161,184,759,7782,8711,929
2980,1475,943,592,5394,1319,15615,Media-Baja,2,2022-07-31,327,622,4506,13652,20121,6469
4551,2846,2433,1151,5119,3234,35535,Media-Alta,3,2022-07-31,551,884,7034,20769,42569,21800
1460,897,340,191,3520,650,10791,Baja,4,2022-07-31,157,160,922,7375,11713,4338
2959,1837,1162,541,4613,1383,16472,Media-Baja,5,2022-07-31,289,515,4719,13299,21191,7892
2658,1659,1023,496,5327,1793,17223,Media-Baja,6,2022-07-31,241,616,4395,13813,21618,7805
4926,4285,3210,2424,9345,4981,92260,Alta,7,2022-07-31,6183,4530,17883,39884,110143,70259
4654,2824,2780,1200,8234,2924,35398,Media-Alta,8,2022-07-31,530,665,8250,23811,43648,19837
4923,3549,3526,2202,9029,4857,84440,Alta,9,2022-07-31,5927,5253,17554,39266,101994,62728
2866,1590,1313,642,5680,1448,18711,Media-Baja,10,2022-07-31,306,510,5648,14355,24359,10004
2503,1717,1301,532,5511,1474,15935,Media-Baja,11,2022-07-31,254,586,4526,13878,20461,6583
3153,1725,1162,662,5775,1510,17304,Media-Baja,12,2022-07-31,297,527,4290,14811,21594,6783
4275,3724,2420,1122,5934,2905,37385,Media-Alta,13,2022-07-31,516,820,7363,21716,44748,23032
2976,1749,1040,521,5873,1436,14888,Media-Baja,14,2022-07-31,292,574,5490,14461,20378,5917
1497,646,431,217,4406,691,8091,Baja,15,2022-07-31,185,161,893,8234,8984,750
2610,1661,1221,642,5885,1482,15685,Media-Baja,16,2022-07-31,265,583,4570,14349,20255,5906
2975,1761,1032,592,4899,1255,16963,Media-Baja,17,2022-07-31,291,628,5031,13433,21994,8561
3202,1553,976,509,4615,1213,19084,Media-Baja,18,2022-07-31,306,570,4999,12944,24083,11139
3096,1598,1076,560,5929,1435,16898,Media-Baja,19,2022-07-31,250,610,4701,14554,21599,7045
2772,1530,935,576,5071,1409,19243,Media-Baja,20,2022-07-31,295,519,4738,13107,23981,10874
4071,3083,2225,1293,6167,3212,31753,Media-Alta,21,2022-07-31,517,774,8497,21342,40250,18908
5040,4057,2267,1058,5282,3570,38666,Media-Alta,22,2022-07-31,575,744,7494,22593,46160,23567
2535,1534,1165,558,5102,1783,18648,Media-Baja,23,2022-07-31,271,554,4528,13502,23176,9674
1534,905,407,185,3483,601,9328,Baja,24,2022-07-31,159,151,750,7425,10078,2653
6215,5044,4202,1780,10160,5324,68636,Alta,25,2022-07-31,5722,5293,17967,43740,86603,42863
4565,3403,2641,1312,6396,2964,30928,Media-Alta,26,2022-07-31,568,788,7107,22637,38035,15398
1547,884,396,246,3431,705,8860,Baja,27,2022-07-31,154,189,854,7552,9714,2162
4430,3125,2185,1088,6342,3034,42247,Media-Alta,28,2022-07-31,526,926,8158,21656,50405,28749
1303,775,390,247,4073,753,9664,Baja,29,2022-07-31,169,200,833,7910,10497,2587
2714,1598,1174,485,4431,1656,17689,Media-Baja,30,2022-07-31,265,488,5339,12811,23028,10217
3720,3965,2163,1253,6844,2788,31572,Media-Alta,31,2022-07-31,551,853,9162,22137,40734,18597
1629,910,404,258,4300,581,8796,Baja,32,2022-07-31,202,164,750,8448,9546,1098
6090,4953,3349,1918,9805,4817,67886,Alta,33,2022-07-31,6214,5588,15403,42734,83289,40555
2437,1747,1113,552,3756,1110,18334,Media-Baja,34,2022-07-31,272,655,5031,11642,23365,11723
2801,1875,1179,507,5060,1107,16759,Media-Baja,35,2022-07-31,319,459,5273,13307,22032,8725
2788,1697,918,611,4046,1382,17022,Media-Baja,36,2022-07-31,312,515,5244,12269,22266,9997
2777,1434,1182,652,4943,1429,17306,Media-Baja,37,2022-07-31,247,570,5454,13234,22760,9526
2412,1831,1018,480,5643,1484,16751,Media-Baja,38,2022-07-31,322,654,4939,13844,21690,7846
6980,4788,3302,2180,9061,4252,84311,Alta,39,2022-07-31,5201,5677,13952,41441,98263,56822
5257,3521,3974,1893,10086,4716,79511,Alta,40,2022-07-31,6591,4440,14052,40478,93563,53085
5820,4518,3284,2139,11582,4525,76273,Alta,41,2022-07-31,5624,5298,19278,42790,95551,52761
4390,2840,2254,1320,5848,2594,33804,Media-Alta,42,2022-07-31,540,909,8140,20695,41944,21249
6171,4525,3468,2106,8410,4215,89954,Alta,43,2022-07-31,5550,5399,16980,39844,106934,67090
7079,4833,4394,1813,9563,4734,74129,Alta,44,2022-07-31,5534,4588,12282,42538,86411,43873
3842,3045,2006,998,6568,2879,33467,Media-Alta,45,2022-07-31,597,895,8216,20830,41683,20853
3993,3131,2070,1419,5939,2773,31387,Media-Alta,46,2022-07-31,601,778,6401,20704,37788,17084
2648,1666,1151,527,4745,1576,16801,Media-Baja,47,2022-07-31,280,585,5196,13178,21997,8819
2559,1584,1215,585,4461,1243,16280,Media-Baja,48,2022-07-31,251,534,4810,12432,21090,8658
3014,1932,892,455,5796,1680,17650,Media-Baja,49,2022-07-31,252,541,5628,14562,23278,8716
2975,1988,985,537,5597,1407,18759,Media-Baja,50,2022-07-31,285,434,5045,14208,23804,9596
1469,831,344,217,3765,646,10044,Baja,51,2022-07-31,182,193,753,7647,10797,3150
4174,3385,2103,959,5424,2824,37528,Media-Alta,52,2022-07-31,558,1004,8577,20431,46105,25674
1457,946,378,198,3820,720,9331,Baja,53,2022-07-31,168,186,939,7873,10270,2397
4640,3018,2452,1223,7685,2429,34032,Media-Alta,54,2022-07-31,643,926,8773,23016,42805,19789
2886,1726,1059,598,4383,1464,18654,Media-Baja,55,2022-07-31,308,617,4567,13041,23221,10180
1474,754,383,262,3959,680,9481,Baja,56,2022-07-31,156,164,808,7832,10289,2457
2850,1914,1163,483,4632,1116,16470,Media-Baja,57,2022-07-31,244,504,4241,12906,20711,7805
2629,2087,1064,549,5143,1417,18384,Media-Baja,58,2022-07-31,278,602,4904,13769,23288,9519
3525,2815,2318,1053,5506,2830,35601,Media-Alta,59,2022-07-31,474,920,9283,19441,44884,25443
2777,1648,1167,761,5133,1342,16640,Media-Baja,60,2022-07-31,281,648,4435,13757,21075,7318
2286,1726,1370,679,4997,1282,15910,Media-Baja,61,2022-07-31,291,615,4955,13246,20865,7619
3777,3355,2177,1221,6426,2624,29482,Media-Alta,62,2022-07-31,552,781,8393,20913,37875,16962
2826,1762,1185,578,5938,1478,16093,Media-Baja,63,2022-07-31,227,602,4382,14596,20475,5879
4112,2977,1939,1020,5797,3059,27281,Media-Alta,64,2022-07-31,489,951,6747,20344,34028,13684
5212,3183,2671,1077,7571,2245,34939,Media-Alta,65,2022-07-31,614,953,9137,23526,44076,20550
3806,3372,2225,1128,5481,3147,35243,Media-Alta,66,2022-07-31,567,952,7499,20678,42742,22064
4822,3559,2513,1180,6968,2581,31859,Media-Alta,67,2022-07-31,462,756,7135,22841,38994,16153
1376,811,377,230,4473,721,10291,Baja,69,2022-07-31,156,174,919,8318,11210,2892
2810,1951,1265,565,4767,1597,14945,Media-Baja,70,2022-07-31,260,566,4722,13781,19667,5886
5808,4401,3588,2237,8645,3799,71830,Alta,71,2022-07-31,6854,4337,19841,39669,91671,52002
1426,982,378,234,3803,721,9644,Baja,72,2022-07-31,170,192,758,7906,10402,2496
1551,835,479,237,4226,687,9493,Baja,73,2022-07-31,181,203,897,8399,10390,1991
2707,1547,1220,579,5045,977,16216,Media-Baja,74,2022-07-31,265,634,5537,12974,21753,8779
4533,2481,2412,922,6584,3102,31939,Media-Alta,75,2022-07-31,575,821,9107,21430,41046,19616
3033,1808,1125,519,4680,1216,16272,Media-Baja,76,2022-07-31,233,644,5638,13258,21910,8652
2911,1692,1118,579,5692,1602,15781,Media-Baja,77,2022-07-31,288,577,5212,14459,20993,6534
3807,3477,2475,1036,6610,2679,32078,Media-Alta,79,2022-07-31,495,878,8486,21457,40564,19107
4399,2878,1942,1320,5465,2649,36968,Media-Alta,80,2022-07-31,566,797,7796,20016,44764,24748
2832,1751,1091,499,5112,1465,18607,Media-Baja,81,2022-07-31,260,537,4442,13547,23049,9502
1238,984,404,251,3965,585,10083,Baja,82,2022-07-31,152,193,939,7772,11022,3250
1512,949,458,238,3302,619,9416,Baja,83,2022-07-31,167,180,711,7425,10127,2702
2820,1559,1175,557,5187,1492,16023,Media-Baja,84,2022-07-31,265,688,5133,13743,21156,7413
1346,847,494,221,4014,798,8581,Baja,85,2022-07-31,200,177,851,8097,9432,1335
1491,649,370,210,4259,774,9012,Baja,86,2022-07-31,162,167,929,8082,9941,1859
3361,1646,1091,558,5062,1510,14884,Media-Baja,87,2022-07-31,238,567,5757,14033,20641,6608
2609,1973,1113,494,5934,1408,15971,Media-Baja,88,2022-07-31,264,620,5266,14415,21237,6822
1276,989,356,229,3658,835,9243,Baja,89,2022-07-31,158,170,803,7671,10046,2375
1324,917,363,258,3795,641,7686,Baja,90,2022-07-31,198,158,790,7654,8476,822
2928,1385,1222,562,5233,1136,16199,Media-Baja,91,2022-07-31,370,575,5160,13411,21359,7948
3934,3271,2636,1334,6288,2928,34633,Media-Alta,92,2022-07-31,577,1008,7273,21976,41906,19930
2871,1890,1151,640,6293,1393,16624,Media-Baja,93,2022-07-31,272,571,5222,15081,21846,6765
2744,1718,1301,607,5080,1489,15374,Media-Baja,94,2022-07-31,275,549,4559,13763,19933,6170
3655,1632,1131,617,5229,1680,19724,Media-Baja,95,2022-07-31,276,675,4401,14895,24125,9230
1562,879,411,257,4432,757,9205,Baja,96,2022-07-31,183,161,845,8642,10050,1408
2947,1722,1286,485,4199,1385,16069,Media-Baja,97,2022-07-31,263,571,5189,12858,21258,8400
1311,803,389,199,3507,635,9710,Baja,98,2022-07-31,145,198,904,7187,10614,3427
3021,1604,1090,561,5376,1414,16847,Media-Baja,99,2022-07-31,262,587,4966,13915,21813,7898
4250,3046,2063,1146,6507,2700,27363,Media-Alta,0,2022-08-31,496,834,8549,21042,35912,14870
1270,917,439,192,3972,647,7952,Baja,1,2022-08-31,191,176,721,7804,8673,869
2980,1475,943,592,5394,1319,15615,Media-Baja,2,2022-08-31,231,642,4016,13576,19631,6055
4551,2846,2433,1151,5119,3234,35535,Media-Alta,3,2022-08-31,646,960,7951,20940,43486,22546
1460,897,340,191,3520,650,10791,Baja,4,2022-08-31,167,184,763,7409,11554,4145
2959,1837,1162,541,4613,1383,16472,Media-Baja,5,2022-08-31,314,573,6003,13382,22475,9093
2658,1659,1023,496,5327,1793,17223,Media-Baja,6,2022-08-31,279,536,5186,13771,22409,8638
4926,4285,3210,2424,9345,4981,92260,Alta,7,2022-08-31,5439,5686,18150,40296,110410,70114
4654,2824,2780,1200,8234,2924,35398,Media-Alta,8,2022-08-31,607,791,8122,24014,43520,19506
4923,3549,3526,2202,9029,4857,84440,Alta,9,2022-08-31,5341,4893,16652,38320,101092,62772
2866,1590,1313,642,5680,1448,18711,Media-Baja,10,2022-08-31,230,717,4903,14486,23614,9128
2503,1717,1301,532,5511,1474,15935,Media-Baja,11,2022-08-31,265,476,5282,13779,21217,7438
3153,1725,1162,662,5775,1510,17304,Media-Baja,12,2022-08-31,301,664,4882,14952,22186,7234
4275,3724,2420,1122,5934,2905,37385,Media-Alta,13,2022-08-31,623,824,8326,21827,45711,23884
2976,1749,1040,521,5873,1436,14888,Media-Baja,14,2022-08-31,272,626,3842,14493,18730,4237
1497,646,431,217,4406,691,8091,Baja,15,2022-08-31,176,167,976,8231,9067,836
2610,1661,1221,642,5885,1482,15685,Media-Baja,16,2022-08-31,288,540,5267,14329,20952,6623
2975,1761,1032,592,4899,1255,16963,Media-Baja,17,2022-08-31,272,543,4199,13329,21162,7833
3202,1553,976,509,4615,1213,19084,Media-Baja,18,2022-08-31,307,551,5287,12926,24371,11445
3096,1598,1076,560,5929,1435,16898,Media-Baja,19,2022-08-31,255,600,5354,14549,22252,7703
2772,1530,935,576,5071,1409,19243,Media-Baja,20,2022-08-31,250,635,4747,13178,23990,10812
4071,3083,2225,1293,6167,3212,31753,Media-Alta,21,2022-08-31,571,821,7832,21443,39585,18142
5040,4057,2267,1058,5282,3570,38666,Media-Alta,22,2022-08-31,700,767,8164,22741,46830,24089
2535,1534,1165,558,5102,1783,18648,Media-Baja,23,2022-08-31,278,561,5142,13516,23790,10274
1534,905,407,185,3483,601,9328,Baja,24,2022-08-31,167,164,766,7446,10094,2648
6215,5044,4202,1780,10160,5324,68636,Alta,25,2022-08-31,4259,6075,17323,43059,85959,42900
4565,3403,2641,1312,6396,2964,30928,Media-Alta,26,2022-08-31,715,1028,8759,23024,39687,16663
1547,884,396,246,3431,705,8860,Baja,27,2022-08-31,182,165,807,7556,9667,2111
4430,3125,2185,1088,6342,3034,42247,Media-Alta,28,2022-08-31,513,881,7176,21598,49423,27825
1303,775,390,247,4073,753,9664,Baja,29,2022-08-31,193,178,829,7912,10493,2581
2714,1598,1174,485,4431,1656,17689,Media-Baja,30,2022-08-31,252,536,4550,12846,22239,9393
3720,3965,2163,1253,6844,2788,31572,Media-Alta,31,2022-08-31,529,752,6414,22014,37986,15972
1629,910,404,258,4300,581,8796,Baja,32,2022-08-31,172,154,1106,8408,9902,1494
6090,4953,3349,1918,9805,4817,67886,Alta,33,2022-08-31,6391,5120,17641,42443,85527,43084
2437,1747,1113,552,3756,1110,18334,Media-Baja,34,2022-08-31,281,525,4378,11521,22712,11191
2801,1875,1179,507,5060,1107,16759,Media-Baja,35,2022-08-31,293,582,4784,13404,21543,8139
2788,1697,918,611,4046,1382,17022,Media-Baja,36,2022-08-31,296,448,4684,12186,21706,9520
2777,1434,1182,652,4943,1429,17306,Media-Baja,37,2022-08-31,292,569,4845,13278,22151,8873
2412,1831,1018,480,5643,1484,16751,Media-Baja,38,2022-08-31,322,505,4474,13695,21225,7530
6980,4788,3302,2180,9061,4252,84311,Alta,39,2022-08-31,5363,5108,17466,41034,101777,60743
5257,3521,3974,1893,10086,4716,79511,Alta,40,2022-08-31,6136,5456,15972,41039,95483,54444
5820,4518,3284,2139,11582,4525,76273,Alta,41,2022-08-31,5991,5281,18171,43140,94444,51304
4390,2840,2254,1320,5848,2594,33804,Media-Alta,42,2022-08-31,468,750,8351,20464,42155,21691
6171,4525,3468,2106,8410,4215,89954,Alta,43,2022-08-31,5493,5499,19742,39887,109696,69809
7079,4833,4394,1813,9563,4734,74129,Alta,44,2022-08-31,4814,5268,16747,42498,90876,48378
3842,3045,2006,998,6568,2879,33467,Media-Alta,45,2022-08-31,650,1036,8712,21024,42179,21155
3993,3131,2070,1419,5939,2773,31387,Media-Alta,46,2022-08-31,666,927,8244,20918,39631,18713
2648,1666,1151,527,4745,1576,16801,Media-Baja,47,2022-08-31,264,460,6039,13037,22840,9803
2559,1584,1215,585,4461,1243,16280,Media-Baja,48,2022-08-31,285,452,5512,12384,21792,9408
3014,1932,892,455,5796,1680,17650,Media-Baja,49,2022-08-31,314,649,5372,14732,23022,8290
2975,1988,985,537,5597,1407,18759,Media-Baja,50,2022-08-31,244,639,5375,14372,24134,9762
1469,831,344,217,3765,646,10044,Baja,51,2022-08-31,152,152,938,7576,10982,3406
4174,3385,2103,959,5424,2824,37528,Media-Alta,52,2022-08-31,537,910,6745,20316,44273,23957
1457,946,378,198,3820,720,9331,Baja,53,2022-08-31,183,174,834,7876,10165,2289
4640,3018,2452,1223,7685,2429,34032,Media-Alta,54,2022-08-31,480,855,9244,22782,43276,20494
2886,1726,1059,598,4383,1464,18654,Media-Baja,55,2022-08-31,293,551,4881,12960,23535,10575
1474,754,383,262,3959,680,9481,Baja,56,2022-08-31,159,169,729,7840,10210,2370
2850,1914,1163,483,4632,1116,16470,Media-Baja,57,2022-08-31,313,600,4449,13071,20919,7848
2629,2087,1064,549,5143,1417,18384,Media-Baja,58,2022-08-31,301,559,5470,13749,23854,10105
3525,2815,2318,1053,5506,2830,35601,Media-Alta,59,2022-08-31,582,829,7106,19458,42707,23249
2777,1648,1167,761,5133,1342,16640,Media-Baja,60,2022-08-31,267,455,4738,13550,21378,7828
2286,1726,1370,679,4997,1282,15910,Media-Baja,61,2022-08-31,281,497,5345,13118,21255,8137
3777,3355,2177,1221,6426,2624,29482,Media-Alta,62,2022-08-31,522,806,7730,20908,37212,16304
2826,1762,1185,578,5938,1478,16093,Media-Baja,63,2022-08-31,340,552,4419,14659,20512,5853
4112,2977,1939,1020,5797,3059,27281,Media-Alta,64,2022-08-31,641,744,8908,20289,36189,15900
5212,3183,2671,1077,7571,2245,34939,Media-Alta,65,2022-08-31,590,1082,8093,23631,43032,19401
3806,3372,2225,1128,5481,3147,35243,Media-Alta,66,2022-08-31,599,1045,6573,20803,41816,21013
4822,3559,2513,1180,6968,2581,31859,Media-Alta,67,2022-08-31,614,891,8502,23128,40361,17233
1376,811,377,230,4473,721,10291,Baja,69,2022-08-31,137,184,700,8309,10991,2682
2810,1951,1265,565,4767,1597,14945,Media-Baja,70,2022-08-31,309,601,5339,13865,20284,6419
5808,4401,3588,2237,8645,3799,71830,Alta,71,2022-08-31,5814,4394,16155,38686,87985,49299
1426,982,378,234,3803,721,9644,Baja,72,2022-08-31,148,169,827,7861,10471,2610
1551,835,479,237,4226,687,9493,Baja,73,2022-08-31,175,149,767,8339,10260,1921
2707,1547,1220,579,5045,977,16216,Media-Baja,74,2022-08-31,260,495,4703,12830,20919,8089
4533,2481,2412,922,6584,3102,31939,Media-Alta,75,2022-08-31,699,781,6106,21514,38045,16531
3033,1808,1125,519,4680,1216,16272,Media-Baja,76,2022-08-31,252,543,4428,13176,20700,7524
2911,1692,1118,579,5692,1602,15781,Media-Baja,77,2022-08-31,283,505,5636,14382,21417,7035
3807,3477,2475,1036,6610,2679,32078,Media-Alta,79,2022-08-31,647,905,7430,21636,39508,17872
4399,2878,1942,1320,5465,2649,36968,Media-Alta,80,2022-08-31,536,848,6980,20037,43948,23911
2832,1751,1091,499,5112,1465,18607,Media-Baja,81,2022-08-31,284,503,4844,13537,23451,9914
1238,984,404,251,3965,585,10083,Baja,82,2022-08-31,185,148,762,7760,10845,3085
1512,949,458,238,3302,619,9416,Baja,83,2022-08-31,152,188,815,7418,10231,2813
2820,1559,1175,557,5187,1492,16023,Media-Baja,84,2022-08-31,327,581,5896,13698,21919,8221
1346,847,494,221,4014,798,8581,Baja,85,2022-08-31,154,161,813,8035,9394,1359
1491,649,370,210,4259,774,9012,Baja,86,2022-08-31,198,188,821,8139,9833,1694
3361,1646,1091,558,5062,1510,14884,Media-Baja,87,2022-08-31,272,599,5301,14099,20185,6086
2609,1973,1113,494,5934,1408,15971,Media-Baja,88,2022-08-31,311,494,4890,14336,20861,6525
1276,989,356,229,3658,835,9243,Baja,89,2022-08-31,202,153,864,7698,10107,2409
1324,917,363,258,3795,641,7686,Baja,90,2022-08-31,180,162,891,7640,8577,937
2928,1385,1222,562,5233,1136,16199,Media-Baja,91,2022-08-31,264,499,4923,13229,21122,7893
3934,3271,2636,1334,6288,2928,34633,Media-Alta,92,2022-08-31,649,899,7346,21939,41979,20040
2871,1890,1151,640,6293,1393,16624,Media-Baja,93,2022-08-31,238,584,4624,15060,21248,6188
2744,1718,1301,607,5080,1489,15374,Media-Baja,94,2022-08-31,274,669,4786,13882,20160,6278
3655,1632,1131,617,5229,1680,19724,Media-Baja,95,2022-08-31,250,600,4495,14794,24219,9425
1562,879,411,257,4432,757,9205,Baja,96,2022-08-31,143,185,778,8626,9983,1357
2947,1722,1286,485,4199,1385,16069,Media-Baja,97,2022-08-31,266,466,5033,12756,21102,8346
1311,803,389,199,3507,635,9710,Baja,98,2022-08-31,206,192,794,7242,10504,3262
3021,1604,1090,561,5376,1414,16847,Media-Baja,99,2022-08-31,288,448,4839,13802,21686,7884
4250,3046,2063,1146,6507,2700,27363,Media-Alta,0,2022-09-30,591,969,8393,21272,35756,14484
1270,917,439,192,3972,647,7952,Baja,1,2022-09-30,192,173,805,7802,8757,955
2980,1475,943,592,5394,1319,15615,Media-Baja,2,2022-09-30,278,582,5442,13563,21057,7494
4551,2846,2433,1151,5119,3234,35535,Media-Alta,3,2022-09-30,578,790,8190,20702,43725,23023
1460,897,340,191,3520,650,10791,Baja,4,2022-09-30,167,191,727,7416,11518,4102
2959,1837,1162,541,4613,1383,16472,Media-Baja,5,2022-09-30,285,480,5323,13260,21795,8535
2658,1659,1023,496,5327,1793,17223,Media-Baja,6,2022-09-30,270,699,4131,13925,21354,7429
4926,4285,3210,2424,9345,4981,92260,Alta,7,2022-09-30,5666,4855,19044,39692,111304,71612
4654,2824,2780,1200,8234,2924,35398,Media-Alta,8,2022-09-30,553,884,8287,24053,43685,19632
4923,3549,3526,2202,9029,4857,84440,Alta,9,2022-09-30,6238,4613,18902,38937,103342,64405
2866,1590,1313,642,5680,1448,18711,Media-Baja,10,2022-09-30,305,571,5286,14415,23997,9582
2503,1717,1301,532,5511,1474,15935,Media-Baja,11,2022-09-30,272,598,4497,13908,20432,6524
3153,1725,1162,662,5775,1510,17304,Media-Baja,12,2022-09-30,315,562,5618,14864,22922,8058
4275,3724,2420,1122,5934,2905,37385,Media-Alta,13,2022-09-30,616,854,9393,21850,46778,24928
2976,1749,1040,521,5873,1436,14888,Media-Baja,14,2022-09-30,281,534,4577,14410,19465,5055
1497,646,431,217,4406,691,8091,Baja,15,2022-09-30,154,164,980,8206,9071,865
2610,1661,1221,642,5885,1482,15685,Media-Baja,16,2022-09-30,263,625,5744,14389,21429,7040
2975,1761,1032,592,4899,1255,16963,Media-Baja,17,2022-09-30,283,600,4943,13397,21906,8509
3202,1553,976,509,4615,1213,19084,Media-Baja,18,2022-09-30,285,639,4962,12992,24046,11054
3096,1598,1076,560,5929,1435,16898,Media-Baja,19,2022-09-30,271,543,5893,14508,22791,8283
2772,1530,935,576,5071,1409,19243,Media-Baja,20,2022-09-30,315,516,5158,13124,24401,11277
4071,3083,2225,1293,6167,3212,31753,Media-Alta,21,2022-09-30,669,725,8110,21445,39863,18418
5040,4057,2267,1058,5282,3570,38666,Media-Alta,22,2022-09-30,685,632,7346,22591,46012,23421
2535,1534,1165,558,5102,1783,18648,Media-Baja,23,2022-09-30,288,561,5703,13526,24351,10825
1534,905,407,185,3483,601,9328,Baja,24,2022-09-30,188,189,778,7492,10106,2614
6215,5044,4202,1780,10160,5324,68636,Alta,25,2022-09-30,5078,5366,17275,43169,85911,42742
4565,3403,2641,1312,6396,2964,30928,Media-Alta,26,2022-09-30,544,834,8434,22659,39362,16703
1547,884,396,246,3431,705,8860,Baja,27,2022-09-30,125,178,813,7512,9673,2161
4430,3125,2185,1088,6342,3034,42247,Media-Alta,28,2022-09-30,578,920,7857,21702,50104,28402
1303,775,390,247,4073,753,9664,Baja,29,2022-09-30,170,167,785,7878,10449,2571
2714,1598,1174,485,4431,1656,17689,Media-Baja,30,2022-09-30,271,431,5177,12760,22866,10106
3720,3965,2163,1253,6844,2788,31572,Media-Alta,31,2022-09-30,575,812,7417,22120,38989,16869
1629,910,404,258,4300,581,8796,Baja,32,2022-09-30,158,177,808,8417,9604,1187
6090,4953,3349,1918,9805,4817,67886,Alta,33,2022-09-30,6262,5650,15971,42844,83857,41013
2437,1747,1113,552,3756,1110,18334,Media-Baja,34,2022-09-30,324,562,4305,11601,22639,11038
2801,1875,1179,507,5060,1107,16759,Media-Baja,35,2022-09-30,356,654,4608,13539,21367,7828
2788,1697,918,611,4046,1382,17022,Media-Baja,36,2022-09-30,317,499,5050,12258,22072,9814
2777,1434,1182,652,4943,1429,17306,Media-Baja,37,2022-09-30,284,616,4171,13317,21477,8160
2412,1831,1018,480,5643,1484,16751,Media-Baja,38,2022-09-30,334,536,4684,13738,21435,7697
6980,4788,3302,2180,9061,4252,84311,Alta,39,2022-09-30,4409,4523,21069,39495,105380,65885
5257,3521,3974,1893,10086,4716,79511,Alta,40,2022-09-30,5362,4808,16896,39617,96407,56790
5820,4518,3284,2139,11582,4525,76273,Alta,41,2022-09-30,5356,4948,15249,42172,91522,49350
4390,2840,2254,1320,5848,2594,33804,Media-Alta,42,2022-09-30,550,881,7692,20677,41496,20819
6171,4525,3468,2106,8410,4215,89954,Alta,43,2022-09-30,5316,3810,14781,38021,104735,66714
7079,4833,4394,1813,9563,4734,74129,Alta,44,2022-09-30,4974,5077,14366,42467,88495,46028
3842,3045,2006,998,6568,2879,33467,Media-Alta,45,2022-09-30,545,975,8047,20858,41514,20656
3993,3131,2070,1419,5939,2773,31387,Media-Alta,46,2022-09-30,557,846,8625,20728,40012,19284
2648,1666,1151,527,4745,1576,16801,Media-Baja,47,2022-09-30,303,469,5213,13085,22014,8929
2559,1584,1215,585,4461,1243,16280,Media-Baja,48,2022-09-30,306,508,4542,12461,20822,8361
3014,1932,892,455,5796,1680,17650,Media-Baja,49,2022-09-30,221,666,4788,14656,22438,7782
2975,1988,985,537,5597,1407,18759,Media-Baja,50,2022-09-30,259,606,5057,14354,23816,9462
1469,831,344,217,3765,646,10044,Baja,51,2022-09-30,191,158,720,7621,10764,3143
4174,3385,2103,959,5424,2824,37528,Media-Alta,52,2022-09-30,605,843,6111,20317,43639,23322
1457,946,378,198,3820,720,9331,Baja,53,2022-09-30,157,161,856,7837,10187,2350
4640,3018,2452,1223,7685,2429,34032,Media-Alta,54,2022-09-30,601,921,8481,22969,42513,19544
2886,1726,1059,598,4383,1464,18654,Media-Baja,55,2022-09-30,231,573,5634,12920,24288,11368
1474,754,383,262,3959,680,9481,Baja,56,2022-09-30,181,180,748,7873,10229,2356
2850,1914,1163,483,4632,1116,16470,Media-Baja,57,2022-09-30,307,462,5341,12927,21811,8884
2629,2087,1064,549,5143,1417,18384,Media-Baja,58,2022-09-30,308,609,4834,13806,23218,9412
3525,2815,2318,1053,5506,2830,35601,Media-Alta,59,2022-09-30,573,798,6819,19418,42420,23002
2777,1648,1167,761,5133,1342,16640,Media-Baja,60,2022-09-30,266,570,4577,13664,21217,7553
2286,1726,1370,679,4997,1282,15910,Media-Baja,61,2022-09-30,320,630,4218,13290,20128,6838
3777,3355,2177,1221,6426,2624,29482,Media-Alta,62,2022-09-30,558,835,7777,20973,37259,16286
2826,1762,1185,578,5938,1478,16093,Media-Baja,63,2022-09-30,308,660,4272,14735,20365,5630
4112,2977,1939,1020,5797,3059,27281,Media-Alta,64,2022-09-30,668,830,5630,20402,32911,12509
5212,3183,2671,1077,7571,2245,34939,Media-Alta,65,2022-09-30,558,805,8297,23322,43236,19914
3806,3372,2225,1128,5481,3147,35243,Media-Alta,66,2022-09-30,594,821,7922,20574,43165,22591
4822,3559,2513,1180,6968,2581,31859,Media-Alta,67,2022-09-30,576,713,8958,22912,40817,17905
1376,811,377,230,4473,721,10291,Baja,69,2022-09-30,181,162,914,8331,11205,2874
2810,1951,1265,565,4767,1597,14945,Media-Baja,70,2022-09-30,295,642,5240,13892,20185,6293
5808,4401,3588,2237,8645,3799,71830,Alta,71,2022-09-30,6163,4230,18627,38871,90457,51586
1426,982,378,234,3803,721,9644,Baja,72,2022-09-30,178,161,888,7883,10532,2649
1551,835,479,237,4226,687,9493,Baja,73,2022-09-30,175,168,812,8358,10305,1947
2707,1547,1220,579,5045,977,16216,Media-Baja,74,2022-09-30,248,665,5221,12988,21437,8449
4533,2481,2412,922,6584,3102,31939,Media-Alta,75,2022-09-30,603,984,6895,21621,38834,17213
3033,1808,1125,519,4680,1216,16272,Media-Baja,76,2022-09-30,267,544,4882,13192,21154,7962
2911,1692,1118,579,5692,1602,15781,Media-Baja,77,2022-09-30,309,640,4676,14543,20457,5914
3807,3477,2475,1036,6610,2679,32078,Media-Alta,79,2022-09-30,570,993,7741,21647,39819,18172
4399,2878,1942,1320,5465,2649,36968,Media-Alta,80,2022-09-30,536,995,7779,20184,44747,24563
2832,1751,1091,499,5112,1465,18607,Media-Baja,81,2022-09-30,255,541,4663,13546,23270,9724
1238,984,404,251,3965,585,10083,Baja,82,2022-09-30,153,139,940,7719,11023,3304
1512,949,458,238,3302,619,9416,Baja,83,2022-09-30,185,185,876,7448,10292,2844
2820,1559,1175,557,5187,1492,16023,Media-Baja,84,2022-09-30,292,564,4182,13646,20205,6559
1346,847,494,221,4014,798,8581,Baja,85,2022-09-30,162,142,846,8024,9427,1403
1491,649,370,210,4259,774,9012,Baja,86,2022-09-30,178,175,812,8106,9824,1718
3361,1646,1091,558,5062,1510,14884,Media-Baja,87,2022-09-30,265,647,4977,14140,19861,5721
2609,1973,1113,494,5934,1408,15971,Media-Baja,88,2022-09-30,284,616,4969,14431,20940,6509
1276,989,356,229,3658,835,9243,Baja,89,2022-09-30,143,170,837,7656,10080,2424
1324,917,363,258,3795,641,7686,Baja,90,2022-09-30,160,172,914,7630,8600,970
2928,1385,1222,562,5233,1136,16199,Media-Baja,91,2022-09-30,349,632,4588,13447,20787,7340
3934,3271,2636,1334,6288,2928,34633,Media-Alta,92,2022-09-30,548,1089,9583,22028,44216,22188
2871,1890,1151,640,6293,1393,16624,Media-Baja,93,2022-09-30,278,564,4976,15080,21600,6520
2744,1718,1301,607,5080,1489,15374,Media-Baja,94,2022-09-30,249,542,5328,13730,20702,6972
3655,1632,1131,617,5229,1680,19724,Media-Baja,95,2022-09-30,293,537,6170,14774,25894,11120
1562,879,411,257,4432,757,9205,Baja,96,2022-09-30,200,184,956,8682,10161,1479
2947,1722,1286,485,4199,1385,16069,Media-Baja,97,2022-09-30,292,574,4566,12890,20635,7745
1311,803,389,199,3507,635,9710,Baja,98,2022-09-30,172,153,772,7169,10482,3313
3021,1604,1090,561,5376,1414,16847,Media-Baja,99,2022-09-30,299,597,4610,13962,21457,7495
4250,3046,2063,1146,6507,2700,27363,Media-Alta,0,2022-10-31,591,867,9004,21170,36367,15197
1270,917,439,192,3972,647,7952,Baja,1,2022-10-31,181,173,919,7791,8871,1080
2980,1475,943,592,5394,1319,15615,Media-Baja,2,2022-10-31,288,562,3929,13553,19544,5991
4551,2846,2433,1151,5119,3234,35535,Media-Alta,3,2022-10-31,638,888,9007,20860,44542,23682
1460,897,340,191,3520,650,10791,Baja,4,2022-10-31,160,190,786,7408,11577,4169
2959,1837,1162,541,4613,1383,16472,Media-Baja,5,2022-10-31,312,475,4933,13282,21405,8123
2658,1659,1023,496,5327,1793,17223,Media-Baja,6,2022-10-31,251,616,5071,13823,22294,8471
4926,4285,3210,2424,9345,4981,92260,Alta,7,2022-10-31,6286,5301,16564,40758,108824,68066
4654,2824,2780,1200,8234,2924,35398,Media-Alta,8,2022-10-31,615,679,7330,23910,42728,18818
4923,3549,3526,2202,9029,4857,84440,Alta,9,2022-10-31,5053,5567,17380,38706,101820,63114
2866,1590,1313,642,5680,1448,18711,Media-Baja,10,2022-10-31,242,499,5592,14280,24303,10023
2503,1717,1301,532,5511,1474,15935,Media-Baja,11,2022-10-31,322,593,5933,13953,21868,7915
3153,1725,1162,662,5775,1510,17304,Media-Baja,12,2022-10-31,275,559,5234,14821,22538,7717
4275,3724,2420,1122,5934,2905,37385,Media-Alta,13,2022-10-31,505,888,8320,21773,45705,23932
2976,1749,1040,521,5873,1436,14888,Media-Baja,14,2022-10-31,323,643,5225,14561,20113,5552
1497,646,431,217,4406,691,8091,Baja,15,2022-10-31,181,156,803,8225,8894,669
2610,1661,1221,642,5885,1482,15685,Media-Baja,16,2022-10-31,282,581,5882,14364,21567,7203
2975,1761,1032,592,4899,1255,16963,Media-Baja,17,2022-10-31,291,517,5077,13322,22040,8718
3202,1553,976,509,4615,1213,19084,Media-Baja,18,2022-10-31,283,602,5574,12953,24658,11705
3096,1598,1076,560,5929,1435,16898,Media-Baja,19,2022-10-31,299,605,4222,14598,21120,6522
2772,1530,935,576,5071,1409,19243,Media-Baja,20,2022-10-31,289,594,5567,13176,24810,11634
4071,3083,2225,1293,6167,3212,31753,Media-Alta,21,2022-10-31,609,887,8888,21547,40641,19094
5040,4057,2267,1058,5282,3570,38666,Media-Alta,22,2022-10-31,515,883,8274,22672,46940,24268
2535,1534,1165,558,5102,1783,18648,Media-Baja,23,2022-10-31,259,603,5597,13539,24245,10706
1534,905,407,185,3483,601,9328,Baja,24,2022-10-31,185,158,743,7458,10071,2613
6215,5044,4202,1780,10160,5324,68636,Alta,25,2022-10-31,6421,5152,16486,44298,85122,40824
4565,3403,2641,1312,6396,2964,30928,Media-Alta,26,2022-10-31,480,921,7343,22682,38271,15589
1547,884,396,246,3431,705,8860,Baja,27,2022-10-31,173,148,830,7530,9690,2160
4430,3125,2185,1088,6342,3034,42247,Media-Alta,28,2022-10-31,528,707,7365,21439,49612,28173
1303,775,390,247,4073,753,9664,Baja,29,2022-10-31,186,141,912,7868,10576,2708
2714,1598,1174,485,4431,1656,17689,Media-Baja,30,2022-10-31,322,476,5503,12856,23192,10336
3720,3965,2163,1253,6844,2788,31572,Media-Alta,31,2022-10-31,544,950,8129,22227,39701,17474
1629,910,404,258,4300,581,8796,Baja,32,2022-10-31,121,183,792,8386,9588,1202
6090,4953,3349,1918,9805,4817,67886,Alta,33,2022-10-31,5905,4352,17034,41189,84920,43731
2437,1747,1113,552,3756,1110,18334,Media-Baja,34,2022-10-31,251,554,5179,11520,23513,11993
2801,1875,1179,507,5060,1107,16759,Media-Baja,35,2022-10-31,353,460,4948,13342,21707,8365
2788,1697,918,611,4046,1382,17022,Media-Baja,36,2022-10-31,296,577,5572,12315,22594,10279
2777,1434,1182,652,4943,1429,17306,Media-Baja,37,2022-10-31,267,589,4842,13273,22148,8875
2412,1831,1018,480,5643,1484,16751,Media-Baja,38,2022-10-31,257,559,4910,13684,21661,7977
6980,4788,3302,2180,9061,4252,84311,Alta,39,2022-10-31,5678,3850,17167,40091,101478,61387
5257,3521,3974,1893,10086,4716,79511,Alta,40,2022-10-31,5722,5798,17493,40967,97004,56037
5820,4518,3284,2139,11582,4525,76273,Alta,41,2022-10-31,5283,5700,15982,42851,92255,49404
4390,2840,2254,1320,5848,2594,33804,Media-Alta,42,2022-10-31,534,729,9028,20509,42832,22323
6171,4525,3468,2106,8410,4215,89954,Alta,43,2022-10-31,5966,4634,16626,39495,106580,67085
7079,4833,4394,1813,9563,4734,74129,Alta,44,2022-10-31,6345,5180,17001,43941,91130,47189
3842,3045,2006,998,6568,2879,33467,Media-Alta,45,2022-10-31,524,845,7982,20707,41449,20742
3993,3131,2070,1419,5939,2773,31387,Media-Alta,46,2022-10-31,570,832,7718,20727,39105,18378
2648,1666,1151,527,4745,1576,16801,Media-Baja,47,2022-10-31,311,579,5013,13203,21814,8611
2559,1584,1215,585,4461,1243,16280,Media-Baja,48,2022-10-31,225,619,5164,12491,21444,8953
3014,1932,892,455,5796,1680,17650,Media-Baja,49,2022-10-31,344,608,5451,14721,23101,8380
2975,1988,985,537,5597,1407,18759,Media-Baja,50,2022-10-31,256,543,4946,14288,23705,9417
1469,831,344,217,3765,646,10044,Baja,51,2022-10-31,208,165,789,7645,10833,3188
4174,3385,2103,959,5424,2824,37528,Media-Alta,52,2022-10-31,459,1052,7502,20380,45030,24650
1457,946,378,198,3820,720,9331,Baja,53,2022-10-31,165,118,696,7802,10027,2225
4640,3018,2452,1223,7685,2429,34032,Media-Alta,54,2022-10-31,648,729,8064,22824,42096,19272
2886,1726,1059,598,4383,1464,18654,Media-Baja,55,2022-10-31,306,515,6519,12937,25173,12236
1474,754,383,262,3959,680,9481,Baja,56,2022-10-31,162,198,875,7872,10356,2484
2850,1914,1163,483,4632,1116,16470,Media-Baja,57,2022-10-31,267,675,4856,13100,21326,8226
2629,2087,1064,549,5143,1417,18384,Media-Baja,58,2022-10-31,263,592,5351,13744,23735,9991
3525,2815,2318,1053,5506,2830,35601,Media-Alta,59,2022-10-31,511,976,8456,19534,44057,24523
2777,1648,1167,761,5133,1342,16640,Media-Baja,60,2022-10-31,283,590,5363,13701,22003,8302
2286,1726,1370,679,4997,1282,15910,Media-Baja,61,2022-10-31,305,685,4846,13330,20756,7426
3777,3355,2177,1221,6426,2624,29482,Media-Alta,62,2022-10-31,561,820,9045,20961,38527,17566
2826,1762,1185,578,5938,1478,16093,Media-Baja,63,2022-10-31,297,526,5954,14590,22047,7457
4112,2977,1939,1020,5797,3059,27281,Media-Alta,64,2022-10-31,591,944,8916,20439,36197,15758
5212,3183,2671,1077,7571,2245,34939,Media-Alta,65,2022-10-31,542,799,7476,23300,42415,19115
3806,3372,2225,1128,5481,3147,35243,Media-Alta,66,2022-10-31,462,830,9051,20451,44294,23843
4822,3559,2513,1180,6968,2581,31859,Media-Alta,67,2022-10-31,598,845,7777,23066,39636,16570
1376,811,377,230,4473,721,10291,Baja,69,2022-10-31,176,194,861,8358,11152,2794
2810,1951,1265,565,4767,1597,14945,Media-Baja,70,2022-10-31,281,503,5413,13739,20358,6619
5808,4401,3588,2237,8645,3799,71830,Alta,71,2022-10-31,5096,4156,14151,37730,85981,48251
1426,982,378,234,3803,721,9644,Baja,72,2022-10-31,169,158,1055,7871,10699,2828
1551,835,479,237,4226,687,9493,Baja,73,2022-10-31,157,173,642,8345,10135,1790
2707,1547,1220,579,5045,977,16216,Media-Baja,74,2022-10-31,239,585,5114,12899,21330,8431
4533,2481,2412,922,6584,3102,31939,Media-Alta,75,2022-10-31,646,785,8126,21465,40065,18600
3033,1808,1125,519,4680,1216,16272,Media-Baja,76,2022-10-31,262,581,5976,13224,22248,9024
2911,1692,1118,579,5692,1602,15781,Media-Baja,77,2022-10-31,256,549,5842,14399,21623,7224
3807,3477,2475,1036,6610,2679,32078,Media-Alta,79,2022-10-31,595,790,8945,21469,41023,19554
4399,2878,1942,1320,5465,2649,36968,Media-Alta,80,2022-10-31,577,853,8656,20083,45624,25541
2832,1751,1091,499,5112,1465,18607,Media-Baja,81,2022-10-31,285,527,4208,13562,22815,9253
1238,984,404,251,3965,585,10083,Baja,82,2022-10-31,197,193,770,7817,10853,3036
1512,949,458,238,3302,619,9416,Baja,83,2022-10-31,141,177,757,7396,10173,2777
2820,1559,1175,557,5187,1492,16023,Media-Baja,84,2022-10-31,238,565,5541,13593,21564,7971
1346,847,494,221,4014,798,8581,Baja,85,2022-10-31,160,161,758,8041,9339,1298
1491,649,370,210,4259,774,9012,Baja,86,2022-10-31,185,164,712,8102,9724,1622
3361,1646,1091,558,5062,1510,14884,Media-Baja,87,2022-10-31,284,579,5081,14091,19965,5874
2609,1973,1113,494,5934,1408,15971,Media-Baja,88,2022-10-31,292,587,5421,14410,21392,6982
1276,989,356,229,3658,835,9243,Baja,89,2022-10-31,158,151,794,7652,10037,2385
1324,917,363,258,3795,641,7686,Baja,90,2022-10-31,177,185,888,7660,8574,914
2928,1385,1222,562,5233,1136,16199,Media-Baja,91,2022-10-31,308,567,5499,13341,21698,8357
3934,3271,2636,1334,6288,2928,34633,Media-Alta,92,2022-10-31,537,1011,7626,21939,42259,20320
2871,1890,1151,640,6293,1393,16624,Media-Baja,93,2022-10-31,274,569,4677,15081,21301,6220
2744,1718,1301,607,5080,1489,15374,Media-Baja,94,2022-10-31,287,634,4985,13860,20359,6499
3655,1632,1131,617,5229,1680,19724,Media-Baja,95,2022-10-31,300,589,5632,14833,25356,10523
1562,879,411,257,4432,757,9205,Baja,96,2022-10-31,178,158,902,8634,10107,1473
2947,1722,1286,485,4199,1385,16069,Media-Baja,97,2022-10-31,266,503,5595,12793,21664,8871
1311,803,389,199,3507,635,9710,Baja,98,2022-10-31,175,210,820,7229,10530,3301
3021,1604,1090,561,5376,1414,16847,Media-Baja,99,2022-10-31,295,598,4239,13959,21086,7127
4250,3046,2063,1146,6507,2700,27363,Media-Alta,0,2022-11-30,510,935,8503,21157,35866,14709
1270,917,439,192,3972,647,7952,Baja,1,2022-11-30,162,188,808,7787,8760,973
2980,1475,943,592,5394,1319,15615,Media-Baja,2,2022-11-30,265,538,5032,13506,20647,7141
4551,2846,2433,1151,5119,3234,35535,Media-Alta,3,2022-11-30,601,960,7222,20895,42757,21862
1460,897,340,191,3520,650,10791,Baja,4,2022-11-30,148,173,756,7379,11547,4168
2959,1837,1162,541,4613,1383,16472,Media-Baja,5,2022-11-30,298,538,5119,13331,21591,8260
2658,1659,1023,496,5327,1793,17223,Media-Baja,6,2022-11-30,290,527,4854,13773,22077,8304
4926,4285,3210,2424,9345,4981,92260,Alta,7,2022-11-30,6443,5721,15943,41335,108203,66868
4654,2824,2780,1200,8234,2924,35398,Media-Alta,8,2022-11-30,515,801,6895,23932,42293,18361
4923,3549,3526,2202,9029,4857,84440,Alta,9,2022-11-30,6413,4817,17617,39316,102057,62741
2866,1590,1313,642,5680,1448,18711,Media-Baja,10,2022-11-30,303,518,5088,14360,23799,9439
2503,1717,1301,532,5511,1474,15935,Media-Baja,11,2022-11-30,288,609,5339,13935,21274,7339
3153,1725,1162,662,5775,1510,17304,Media-Baja,12,2022-11-30,278,739,4085,15004,21389,6385
4275,3724,2420,1122,5934,2905,37385,Media-Alta,13,2022-11-30,556,823,8087,21759,45472,23713
2976,1749,1040,521,5873,1436,14888,Media-Baja,14,2022-11-30,275,601,4687,14471,19575,5104
1497,646,431,217,4406,691,8091,Baja,15,2022-11-30,185,192,835,8265,8926,661
2610,1661,1221,642,5885,1482,15685,Media-Baja,16,2022-11-30,259,579,5153,14339,20838,6499
2975,1761,1032,592,4899,1255,16963,Media-Baja,17,2022-11-30,199,529,4981,13242,21944,8702
3202,1553,976,509,4615,1213,19084,Media-Baja,18,2022-11-30,356,556,5512,12980,24596,11616
3096,1598,1076,560,5929,1435,16898,Media-Baja,19,2022-11-30,284,583,4957,14561,21855,7294
2772,1530,935,576,5071,1409,19243,Media-Baja,20,2022-11-30,311,721,4570,13325,23813,10488
4071,3083,2225,1293,6167,3212,31753,Media-Alta,21,2022-11-30,564,620,6804,21235,38557,17322
5040,4057,2267,1058,5282,3570,38666,Media-Alta,22,2022-11-30,515,870,8983,22659,47649,24990
2535,1534,1165,558,5102,1783,18648,Media-Baja,23,2022-11-30,270,535,5649,13482,24297,10815
1534,905,407,185,3483,601,9328,Baja,24,2022-11-30,185,157,866,7457,10194,2737
6215,5044,4202,1780,10160,5324,68636,Alta,25,2022-11-30,5584,5008,15485,43317,84121,40804
4565,3403,2641,1312,6396,2964,30928,Media-Alta,26,2022-11-30,613,750,7608,22644,38536,15892
1547,884,396,246,3431,705,8860,Baja,27,2022-11-30,154,165,984,7528,9844,2316
4430,3125,2185,1088,6342,3034,42247,Media-Alta,28,2022-11-30,557,929,9320,21690,51567,29877
1303,775,390,247,4073,753,9664,Baja,29,2022-11-30,143,173,754,7857,10418,2561
2714,1598,1174,485,4431,1656,17689,Media-Baja,30,2022-11-30,247,566,5127,12871,22816,9945
3720,3965,2163,1253,6844,2788,31572,Media-Alta,31,2022-11-30,518,804,7928,22055,39500,17445
1629,910,404,258,4300,581,8796,Baja,32,2022-11-30,176,173,824,8431,9620,1189
6090,4953,3349,1918,9805,4817,67886,Alta,33,2022-11-30,5158,6190,17247,42280,85133,42853
2437,1747,1113,552,3756,1110,18334,Media-Baja,34,2022-11-30,224,509,4932,11448,23266,11818
2801,1875,1179,507,5060,1107,16759,Media-Baja,35,2022-11-30,325,486,5940,13340,22699,9359
2788,1697,918,611,4046,1382,17022,Media-Baja,36,2022-11-30,265,586,5382,12293,22404,10111
2777,1434,1182,652,4943,1429,17306,Media-Baja,37,2022-11-30,281,632,4652,13330,21958,8628
2412,1831,1018,480,5643,1484,16751,Media-Baja,38,2022-11-30,266,548,4632,13682,21383,7701
6980,4788,3302,2180,9061,4252,84311,Alta,39,2022-11-30,6312,5388,18364,42263,102675,60412
5257,3521,3974,1893,10086,4716,79511,Alta,40,2022-11-30,6224,5438,20981,41109,100492,59383
5820,4518,3284,2139,11582,4525,76273,Alta,41,2022-11-30,7169,4441,18687,43478,94960,51482
4390,2840,2254,1320,5848,2594,33804,Media-Alta,42,2022-11-30,655,919,7378,20820,41182,20362
6171,4525,3468,2106,8410,4215,89954,Alta,43,2022-11-30,5048,4902,19088,38845,109042,70197
7079,4833,4394,1813,9563,4734,74129,Alta,44,2022-11-30,5381,5070,16483,42867,90612,47745
3842,3045,2006,998,6568,2879,33467,Media-Alta,45,2022-11-30,709,721,7388,20768,40855,20087
3993,3131,2070,1419,5939,2773,31387,Media-Alta,46,2022-11-30,557,877,8418,20759,39805,19046
2648,1666,1151,527,4745,1576,16801,Media-Baja,47,2022-11-30,314,628,5243,13255,22044,8789
2559,1584,1215,585,4461,1243,16280,Media-Baja,48,2022-11-30,290,544,4956,12481,21236,8755
3014,1932,892,455,5796,1680,17650,Media-Baja,49,2022-11-30,270,610,5002,14649,22652,8003
2975,1988,985,537,5597,1407,18759,Media-Baja,50,2022-11-30,339,641,5231,14469,23990,9521
1469,831,344,217,3765,646,10044,Baja,51,2022-11-30,181,176,726,7629,10770,3141
4174,3385,2103,959,5424,2824,37528,Media-Alta,52,2022-11-30,570,935,8546,20374,46074,25700
1457,946,378,198,3820,720,9331,Baja,53,2022-11-30,168,192,836,7879,10167,2288
4640,3018,2452,1223,7685,2429,34032,Media-Alta,54,2022-11-30,575,945,9256,22967,43288,20321
2886,1726,1059,598,4383,1464,18654,Media-Baja,55,2022-11-30,324,545,4649,12985,23303,10318
1474,754,383,262,3959,680,9481,Baja,56,2022-11-30,154,164,791,7830,10272,2442
2850,1914,1163,483,4632,1116,16470,Media-Baja,57,2022-11-30,316,485,5248,12959,21718,8759
2629,2087,1064,549,5143,1417,18384,Media-Baja,58,2022-11-30,280,543,5053,13712,23437,9725
3525,2815,2318,1053,5506,2830,35601,Media-Alta,59,2022-11-30,608,949,8355,19604,43956,24352
2777,1648,1167,761,5133,1342,16640,Media-Baja,60,2022-11-30,237,594,5518,13659,22158,8499
2286,1726,1370,679,4997,1282,15910,Media-Baja,61,2022-11-30,276,522,5545,13138,21455,8317
3777,3355,2177,1221,6426,2624,29482,Media-Alta,62,2022-11-30,519,905,7156,21004,36638,15634
2826,1762,1185,578,5938,1478,16093,Media-Baja,63,2022-11-30,297,537,4694,14601,20787,6186
4112,2977,1939,1020,5797,3059,27281,Media-Alta,64,2022-11-30,599,960,9013,20463,36294,15831
5212,3183,2671,1077,7571,2245,34939,Media-Alta,65,2022-11-30,583,804,8987,23346,43926,20580
3806,3372,2225,1128,5481,3147,35243,Media-Alta,66,2022-11-30,574,835,8755,20568,43998,23430
4822,3559,2513,1180,6968,2581,31859,Media-Alta,67,2022-11-30,656,868,9136,23147,40995,17848
1376,811,377,230,4473,721,10291,Baja,69,2022-11-30,139,161,818,8288,11109,2821
2810,1951,1265,565,4767,1597,14945,Media-Baja,70,2022-11-30,315,624,5752,13894,20697,6803
5808,4401,3588,2237,8645,3799,71830,Alta,71,2022-11-30,5764,4825,17385,39067,89215,50148
1426,982,378,234,3803,721,9644,Baja,72,2022-11-30,166,166,982,7876,10626,2750
1551,835,479,237,4226,687,9493,Baja,73,2022-11-30,165,160,982,8340,10475,2135
2707,1547,1220,579,5045,977,16216,Media-Baja,74,2022-11-30,260,631,4921,12966,21137,8171
4533,2481,2412,922,6584,3102,31939,Media-Alta,75,2022-11-30,521,762,8416,21317,40355,19038
3033,1808,1125,519,4680,1216,16272,Media-Baja,76,2022-11-30,290,553,4123,13224,20395,7171
2911,1692,1118,579,5692,1602,15781,Media-Baja,77,2022-11-30,304,567,4328,14465,20109,5644
3807,3477,2475,1036,6610,2679,32078,Media-Alta,79,2022-11-30,584,916,8823,21584,40901,19317
4399,2878,1942,1320,5465,2649,36968,Media-Alta,80,2022-11-30,600,844,7237,20097,44205,24108
2832,1751,1091,499,5112,1465,18607,Media-Baja,81,2022-11-30,284,602,4727,13636,23334,9698
1238,984,404,251,3965,585,10083,Baja,82,2022-11-30,143,158,961,7728,11044,3316
1512,949,458,238,3302,619,9416,Baja,83,2022-11-30,135,203,900,7416,10316,2900
2820,1559,1175,557,5187,1492,16023,Media-Baja,84,2022-11-30,300,584,5186,13674,21209,7535
1346,847,494,221,4014,798,8581,Baja,85,2022-11-30,157,185,789,8062,9370,1308
1491,649,370,210,4259,774,9012,Baja,86,2022-11-30,180,162,1038,8095,10050,1955
3361,1646,1091,558,5062,1510,14884,Media-Baja,87,2022-11-30,295,439,5467,13962,20351,6389
2609,1973,1113,494,5934,1408,15971,Media-Baja,88,2022-11-30,344,558,5100,14433,21071,6638
1276,989,356,229,3658,835,9243,Baja,89,2022-11-30,162,178,924,7683,10167,2484
1324,917,363,258,3795,641,7686,Baja,90,2022-11-30,193,180,766,7671,8452,781
2928,1385,1222,562,5233,1136,16199,Media-Baja,91,2022-11-30,301,571,4489,13338,20688,7350
3934,3271,2636,1334,6288,2928,34633,Media-Alta,92,2022-11-30,632,786,7125,21809,41758,19949
2871,1890,1151,640,6293,1393,16624,Media-Baja,93,2022-11-30,278,520,5135,15036,21759,6723
2744,1718,1301,607,5080,1489,15374,Media-Baja,94,2022-11-30,297,590,4632,13826,20006,6180
3655,1632,1131,617,5229,1680,19724,Media-Baja,95,2022-11-30,323,467,5108,14734,24832,10098
1562,879,411,257,4432,757,9205,Baja,96,2022-11-30,165,197,836,8660,10041,1381
2947,1722,1286,485,4199,1385,16069,Media-Baja,97,2022-11-30,299,598,4475,12921,20544,7623
1311,803,389,199,3507,635,9710,Baja,98,2022-11-30,178,152,875,7174,10585,3411
3021,1604,1090,561,5376,1414,16847,Media-Baja,99,2022-11-30,257,495,5660,13818,22507,8689
4250,3046,2063,1146,6507,2700,27363,Media-Alta,0,2022-12-31,607,831,6859,21150,34222,13072
1270,917,439,192,3972,647,7952,Baja,1,2022-12-31,203,170,858,7810,8810,1000
2980,1475,943,592,5394,1319,15615,Media-Baja,2,2022-12-31,322,464,4573,13489,20188,6699
4551,2846,2433,1151,5119,3234,35535,Media-Alta,3,2022-12-31,577,959,7929,20870,43464,22594
1460,897,340,191,3520,650,10791,Baja,4,2022-12-31,177,178,821,7413,11612,4199
2959,1837,1162,541,4613,1383,16472,Media-Baja,5,2022-12-31,324,540,5088,13359,21560,8201
2658,1659,1023,496,5327,1793,17223,Media-Baja,6,2022-12-31,290,592,5140,13838,22363,8525
4926,4285,3210,2424,9345,4981,92260,Alta,7,2022-12-31,4427,5226,13262,38824,105522,66698
4654,2824,2780,1200,8234,2924,35398,Media-Alta,8,2022-12-31,611,913,7638,24140,43036,18896
4923,3549,3526,2202,9029,4857,84440,Alta,9,2022-12-31,5751,5706,13507,39543,97947,58404
2866,1590,1313,642,5680,1448,18711,Media-Baja,10,2022-12-31,262,587,5828,14388,24539,10151
2503,1717,1301,532,5511,1474,15935,Media-Baja,11,2022-12-31,272,491,4790,13801,20725,6924
3153,1725,1162,662,5775,1510,17304,Media-Baja,12,2022-12-31,283,536,5168,14806,22472,7666
4275,3724,2420,1122,5934,2905,37385,Media-Alta,13,2022-12-31,571,899,8467,21850,45852,24002
2976,1749,1040,521,5873,1436,14888,Media-Baja,14,2022-12-31,321,679,4842,14595,19730,5135
1497,646,431,217,4406,691,8091,Baja,15,2022-12-31,174,172,985,8234,9076,842
2610,1661,1221,642,5885,1482,15685,Media-Baja,16,2022-12-31,285,546,4664,14332,20349,6017
2975,1761,1032,592,4899,1255,16963,Media-Baja,17,2022-12-31,316,574,4677,13404,21640,8236
3202,1553,976,509,4615,1213,19084,Media-Baja,18,2022-12-31,284,619,4841,12971,23925,10954
3096,1598,1076,560,5929,1435,16898,Media-Baja,19,2022-12-31,268,682,5604,14644,22502,7858
2772,1530,935,576,5071,1409,19243,Media-Baja,20,2022-12-31,272,564,4679,13129,23922,10793
4071,3083,2225,1293,6167,3212,31753,Media-Alta,21,2022-12-31,525,904,8296,21480,40049,18569
5040,4057,2267,1058,5282,3570,38666,Media-Alta,22,2022-12-31,615,820,8110,22709,46776,24067
2535,1534,1165,558,5102,1783,18648,Media-Baja,23,2022-12-31,284,630,5727,13591,24375,10784
1534,905,407,185,3483,601,9328,Baja,24,2022-12-31,148,190,859,7453,10187,2734
6215,5044,4202,1780,10160,5324,68636,Alta,25,2022-12-31,5078,5537,15734,43340,84370,41030
4565,3403,2641,1312,6396,2964,30928,Media-Alta,26,2022-12-31,464,955,9235,22700,40163,17463
1547,884,396,246,3431,705,8860,Baja,27,2022-12-31,170,149,703,7528,9563,2035
4430,3125,2185,1088,6342,3034,42247,Media-Alta,28,2022-12-31,587,878,8165,21669,50412,28743
1303,775,390,247,4073,753,9664,Baja,29,2022-12-31,162,132,983,7835,10647,2812
2714,1598,1174,485,4431,1656,17689,Media-Baja,30,2022-12-31,313,624,4696,12995,22385,9390
3720,3965,2163,1253,6844,2788,31572,Media-Alta,31,2022-12-31,570,971,7149,22274,38721,16447
1629,910,404,258,4300,581,8796,Baja,32,2022-12-31,162,152,785,8396,9581,1185
6090,4953,3349,1918,9805,4817,67886,Alta,33,2022-12-31,5821,4901,17063,41654,84949,43295
2437,1747,1113,552,3756,1110,18334,Media-Baja,34,2022-12-31,299,622,4851,11636,23185,11549
2801,1875,1179,507,5060,1107,16759,Media-Baja,35,2022-12-31,306,518,5528,13353,22287,8934
2788,1697,918,611,4046,1382,17022,Media-Baja,36,2022-12-31,279,540,5240,12261,22262,10001
2777,1434,1182,652,4943,1429,17306,Media-Baja,37,2022-12-31,273,507,3688,13197,20994,7797
2412,1831,1018,480,5643,1484,16751,Media-Baja,38,2022-12-31,257,594,5543,13719,22294,8575
6980,4788,3302,2180,9061,4252,84311,Alta,39,2022-12-31,5114,4231,18014,39908,102325,62417
5257,3521,3974,1893,10086,4716,79511,Alta,40,2022-12-31,4800,6334,17905,40581,97416,56835
5820,4518,3284,2139,11582,4525,76273,Alta,41,2022-12-31,5327,5711,16603,42906,92876,49970
4390,2840,2254,1320,5848,2594,33804,Media-Alta,42,2022-12-31,521,844,8173,20611,41977,21366
6171,4525,3468,2106,8410,4215,89954,Alta,43,2022-12-31,4965,5301,17802,39161,107756,68595
7079,4833,4394,1813,9563,4734,74129,Alta,44,2022-12-31,5098,4876,17487,42390,91616,49226
3842,3045,2006,998,6568,2879,33467,Media-Alta,45,2022-12-31,581,716,7969,20635,41436,20801
3993,3131,2070,1419,5939,2773,31387,Media-Alta,46,2022-12-31,517,1011,6135,20853,37522,16669
2648,1666,1151,527,4745,1576,16801,Media-Baja,47,2022-12-31,306,561,4450,13180,21251,8071
2559,1584,1215,585,4461,1243,16280,Media-Baja,48,2022-12-31,229,566,5100,12442,21380,8938
3014,1932,892,455,5796,1680,17650,Media-Baja,49,2022-12-31,319,672,4573,14760,22223,7463
2975,1988,985,537,5597,1407,18759,Media-Baja,50,2022-12-31,275,632,5634,14396,24393,9997
1469,831,344,217,3765,646,10044,Baja,51,2022-12-31,167,184,907,7623,10951,3328
4174,3385,2103,959,5424,2824,37528,Media-Alta,52,2022-12-31,650,831,9038,20350,46566,26216
1457,946,378,198,3820,720,9331,Baja,53,2022-12-31,176,154,750,7849,10081,2232
4640,3018,2452,1223,7685,2429,34032,Media-Alta,54,2022-12-31,545,731,8169,22723,42201,19478
2886,1726,1059,598,4383,1464,18654,Media-Baja,55,2022-12-31,262,724,5027,13102,23681,10579
1474,754,383,262,3959,680,9481,Baja,56,2022-12-31,151,193,785,7856,10266,2410
2850,1914,1163,483,4632,1116,16470,Media-Baja,57,2022-12-31,312,496,5964,12966,22434,9468
2629,2087,1064,549,5143,1417,18384,Media-Baja,58,2022-12-31,251,554,4586,13694,22970,9276
3525,2815,2318,1053,5506,2830,35601,Media-Alta,59,2022-12-31,655,959,8913,19661,44514,24853
2777,1648,1167,761,5133,1342,16640,Media-Baja,60,2022-12-31,273,500,4562,13601,21202,7601
2286,1726,1370,679,4997,1282,15910,Media-Baja,61,2022-12-31,313,593,5199,13246,21109,7863
3777,3355,2177,1221,6426,2624,29482,Media-Alta,62,2022-12-31,616,909,7139,21105,36621,15516
2826,1762,1185,578,5938,1478,16093,Media-Baja,63,2022-12-31,238,576,4366,14581,20459,5878
4112,2977,1939,1020,5797,3059,27281,Media-Alta,64,2022-12-31,579,960,9380,20443,36661,16218
5212,3183,2671,1077,7571,2245,34939,Media-Alta,65,2022-12-31,636,780,8352,23375,43291,19916
3806,3372,2225,1128,5481,3147,35243,Media-Alta,66,2022-12-31,565,911,6943,20635,42186,21551
4822,3559,2513,1180,6968,2581,31859,Media-Alta,67,2022-12-31,509,806,8080,22938,39939,17001
1376,811,377,230,4473,721,10291,Baja,69,2022-12-31,161,197,893,8346,11184,2838
2810,1951,1265,565,4767,1597,14945,Media-Baja,70,2022-12-31,300,638,4882,13893,19827,5934
5808,4401,3588,2237,8645,3799,71830,Alta,71,2022-12-31,5081,4651,17523,38210,89353,51143
1426,982,378,234,3803,721,9644,Baja,72,2022-12-31,141,189,785,7874,10429,2555
1551,835,479,237,4226,687,9493,Baja,73,2022-12-31,169,185,855,8369,10348,1979
2707,1547,1220,579,5045,977,16216,Media-Baja,74,2022-12-31,338,515,4602,12928,20818,7890
4533,2481,2412,922,6584,3102,31939,Media-Alta,75,2022-12-31,601,848,8955,21483,40894,19411
3033,1808,1125,519,4680,1216,16272,Media-Baja,76,2022-12-31,224,590,4800,13195,21072,7877
2911,1692,1118,579,5692,1602,15781,Media-Baja,77,2022-12-31,323,666,4755,14583,20536,5953
3807,3477,2475,1036,6610,2679,32078,Media-Alta,79,2022-12-31,553,766,8718,21403,40796,19393
4399,2878,1942,1320,5465,2649,36968,Media-Alta,80,2022-12-31,512,957,8044,20122,45012,24890
2832,1751,1091,499,5112,1465,18607,Media-Baja,81,2022-12-31,284,571,5630,13605,24237,10632
1238,984,404,251,3965,585,10083,Baja,82,2022-12-31,143,205,920,7775,11003,3228
1512,949,458,238,3302,619,9416,Baja,83,2022-12-31,156,175,981,7409,10397,2988
2820,1559,1175,557,5187,1492,16023,Media-Baja,84,2022-12-31,313,558,5329,13661,21352,7691
1346,847,494,221,4014,798,8581,Baja,85,2022-12-31,203,192,796,8115,9377,1262
1491,649,370,210,4259,774,9012,Baja,86,2022-12-31,195,192,894,8140,9906,1766
3361,1646,1091,558,5062,1510,14884,Media-Baja,87,2022-12-31,263,570,4809,14061,19693,5632
2609,1973,1113,494,5934,1408,15971,Media-Baja,88,2022-12-31,284,587,5637,14402,21608,7206
1276,989,356,229,3658,835,9243,Baja,89,2022-12-31,189,164,985,7696,10228,2532
1324,917,363,258,3795,641,7686,Baja,90,2022-12-31,150,203,873,7651,8559,908
2928,1385,1222,562,5233,1136,16199,Media-Baja,91,2022-12-31,332,528,5032,13326,21231,7905
3934,3271,2636,1334,6288,2928,34633,Media-Alta,92,2022-12-31,584,704,8461,21679,43094,21415
2871,1890,1151,640,6293,1393,16624,Media-Baja,93,2022-12-31,242,527,5430,15007,22054,7047
2744,1718,1301,607,5080,1489,15374,Media-Baja,94,2022-12-31,308,601,5148,13848,20522,6674
3655,1632,1131,617,5229,1680,19724,Media-Baja,95,2022-12-31,328,573,4463,14845,24187,9342
1562,879,411,257,4432,757,9205,Baja,96,2022-12-31,150,165,1032,8613,10237,1624
2947,1722,1286,485,4199,1385,16069,Media-Baja,97,2022-12-31,314,544,4339,12882,20408,7526
1311,803,389,199,3507,635,9710,Baja,98,2022-12-31,150,162,799,7156,10509,3353
3021,1604,1090,561,5376,1414,16847,Media-Baja,99,2022-12-31,305,546,5481,13917,22328,8411
4483,3214,2176,1209,6865,2848,28868,Media-Alta,0,2023-01-31,599,918,5928,22312,34796,12484
1340,967,464,203,4190,682,8389,Baja,1,2023-01-31,192,192,860,8230,9249,1019
3144,1556,995,625,5690,1392,16474,Media-Baja,2,2023-01-31,305,669,4669,14376,21143,6767
4802,3002,2567,1215,5401,3412,37489,Media-Alta,3,2023-01-31,586,781,8134,21766,45623,23857
1541,947,359,201,3714,686,11385,Baja,4,2023-01-31,183,181,935,7812,12320,4508
3121,1938,1226,570,4867,1459,17378,Media-Baja,5,2023-01-31,298,570,4877,14049,22255,8206
2804,1750,1079,524,5620,1892,18170,Media-Baja,6,2023-01-31,314,591,4704,14574,22874,8300
5197,4521,3387,2558,9859,5255,97334,Alta,7,2023-01-31,5521,5380,17261,41678,114595,72917
4910,2979,2933,1267,8687,3085,37345,Media-Alta,8,2023-01-31,669,985,7972,25515,45317,19802
5194,3744,3720,2323,9526,5124,89084,Alta,9,2023-01-31,5991,5599,15910,41221,104994,63773
3024,1678,1386,677,5992,1527,19740,Media-Baja,10,2023-01-31,257,596,4828,15137,24568,9431
2640,1811,1372,561,5814,1555,16812,Media-Baja,11,2023-01-31,308,474,5721,14535,22533,7998
3327,1819,1226,698,6093,1593,18256,Media-Baja,12,2023-01-31,323,598,4924,15677,23180,7503
4510,3929,2553,1184,6260,3065,39441,Media-Alta,13,2023-01-31,640,950,8073,23091,47514,24423
3139,1845,1097,550,6196,1515,15707,Media-Baja,14,2023-01-31,299,709,5271,15350,20978,5628
1579,681,455,229,4648,729,8536,Baja,15,2023-01-31,201,165,706,8687,9242,555
2753,1752,1288,677,6208,1563,16548,Media-Baja,16,2023-01-31,316,546,4925,15103,21473,6370
3138,1858,1089,625,5168,1324,17896,Media-Baja,17,2023-01-31,314,645,4953,14161,22849,8688
3379,1638,1030,537,4869,1280,20133,Media-Baja,18,2023-01-31,318,561,4662,13612,24795,11183
3267,1686,1135,591,6255,1514,17828,Media-Baja,19,2023-01-31,292,527,4601,15267,22429,7162
2924,1614,986,608,5350,1486,20302,Media-Baja,20,2023-01-31,290,693,5491,13951,25793,11842
4295,3252,2347,1364,6506,3388,33499,Media-Alta,21,2023-01-31,537,863,7547,22552,41046,18494
5318,4280,2392,1116,5572,3767,40793,Media-Alta,22,2023-01-31,623,970,8101,24038,48894,24856
2674,1619,1229,589,5382,1881,19674,Media-Baja,23,2023-01-31,335,658,5296,14367,24970,10603
1619,955,430,195,3674,634,9841,Baja,24,2023-01-31,169,174,931,7850,10772,2922
6557,5321,4433,1878,10719,5617,72411,Alta,25,2023-01-31,6815,5298,17980,46638,90391,43753
4816,3590,2786,1384,6748,3127,32629,Media-Alta,26,2023-01-31,488,823,8049,23762,40678,16916
1632,932,418,259,3620,744,9347,Baja,27,2023-01-31,176,163,803,7944,10150,2206
4673,3297,2305,1147,6690,3201,44571,Media-Alta,28,2023-01-31,640,888,8377,22841,52948,30107
1375,818,412,260,4297,794,10196,Baja,29,2023-01-31,171,183,885,8310,11081,2771
2863,1686,1239,512,4674,1747,18662,Media-Baja,30,2023-01-31,322,634,5860,13677,24522,10845
3924,4183,2282,1322,7220,2941,33308,Media-Alta,31,2023-01-31,549,1059,8501,23480,41809,18329
1718,960,426,272,4536,613,9280,Baja,32,2023-01-31,192,197,782,8914,10062,1148
6425,5225,3534,2024,10345,5082,71620,Alta,33,2023-01-31,6568,4838,19029,44041,90649,46608
2571,1844,1174,583,3963,1172,19342,Media-Baja,34,2023-01-31,245,506,4772,12058,24114,12056
2955,1978,1244,534,5338,1168,17681,Media-Baja,35,2023-01-31,292,628,4212,14137,21893,7756
2941,1791,968,645,4268,1458,17959,Media-Baja,36,2023-01-31,296,669,4463,13036,22422,9386
2930,1513,1247,688,5215,1508,18258,Media-Baja,37,2023-01-31,304,601,4665,14006,22923,8917
2544,1931,1074,507,5953,1566,17673,Media-Baja,38,2023-01-31,300,573,5318,14448,22991,8543
7364,5052,3483,2300,9560,4486,88948,Alta,39,2023-01-31,5568,6333,17415,44146,106363,62217
5546,3715,4192,1997,10640,4975,83884,Alta,40,2023-01-31,6623,5333,16697,43021,100581,57560
6140,4767,3465,2257,12219,4774,80468,Alta,41,2023-01-31,5699,5544,15680,44865,96148,51283
4631,2996,2378,1393,6170,2737,35663,Media-Alta,42,2023-01-31,561,889,9340,21755,45003,23248
6510,4774,3659,2222,8872,4447,94901,Alta,43,2023-01-31,6107,5545,15602,42136,110503,68367
7468,5099,4636,1913,10089,4994,78206,Alta,44,2023-01-31,4726,4558,14715,43483,92921,49438
4053,3213,2116,1053,6930,3037,35307,Media-Alta,45,2023-01-31,690,991,8769,22083,44076,21993
4213,3303,2184,1497,6266,2925,33114,Media-Alta,46,2023-01-31,667,907,7823,21962,40937,18975
2793,1758,1215,556,5006,1663,17726,Media-Baja,47,2023-01-31,290,534,4581,13815,22307,8492
2699,1672,1282,617,4707,1311,17175,Media-Baja,48,2023-01-31,284,629,4793,13201,21968,8767
3180,2038,941,480,6115,1773,18621,Media-Baja,49,2023-01-31,320,584,4503,15431,23124,7693
3138,2097,1039,567,5905,1484,19791,Media-Baja,50,2023-01-31,281,640,5200,15151,24991,9840
1550,877,363,229,3972,681,10596,Baja,51,2023-01-31,188,206,930,8066,11526,3460
4404,3571,2219,1012,5723,2979,39592,Media-Alta,52,2023-01-31,560,917,8996,21385,48588,27203
1537,998,399,209,4030,759,9845,Baja,53,2023-01-31,180,169,878,8281,10723,2442
4896,3184,2586,1291,8108,2562,35904,Media-Alta,54,2023-01-31,673,990,7942,24290,43846,19556
3044,1821,1117,631,4624,1544,19680,Media-Baja,55,2023-01-31,294,528,4329,13603,24009,10406
1555,795,405,276,4177,717,10002,Baja,56,2023-01-31,167,183,943,8275,10945,2670
3007,2019,1227,509,4887,1178,17376,Media-Baja,57,2023-01-31,371,385,4157,13583,21533,7950
2774,2202,1122,579,5426,1495,19395,Media-Baja,58,2023-01-31,268,586,5336,14452,24731,10279
3719,2970,2446,1111,5809,2985,37559,Media-Alta,59,2023-01-31,637,870,7225,20547,44784,24237
2930,1739,1232,802,5415,1416,17555,Media-Baja,60,2023-01-31,328,595,5193,14457,22748,8291
2412,1821,1446,716,5272,1353,16786,Media-Baja,61,2023-01-31,301,609,4641,13930,21427,7497
3984,3540,2297,1288,6779,2768,31104,Media-Alta,62,2023-01-31,649,1041,6805,22346,37909,15563
2982,1859,1250,610,6265,1560,16978,Media-Baja,63,2023-01-31,301,620,5723,15447,22701,7254
4338,3141,2045,1077,6116,3227,28781,Media-Alta,64,2023-01-31,521,888,7373,21353,36154,14801
5499,3358,2818,1137,7987,2369,36860,Media-Alta,65,2023-01-31,650,901,7827,24719,44687,19968
4016,3558,2347,1190,5783,3320,37181,Media-Alta,66,2023-01-31,657,766,9191,21637,46372,24735
5087,3755,2651,1245,7351,2723,33611,Media-Alta,67,2023-01-31,692,783,7955,24287,41566,17279
1452,855,397,242,4719,760,10857,Baja,69,2023-01-31,195,189,870,8809,11727,2918
2965,2059,1335,596,5029,1685,15767,Media-Baja,70,2023-01-31,307,653,4580,14629,20347,5718
6128,4643,3785,2360,9121,4008,75781,Alta,71,2023-01-31,5890,3921,14846,39856,90627,50771
1505,1036,399,247,4012,760,10174,Baja,72,2023-01-31,180,185,950,8324,11124,2800
1637,881,506,250,4458,724,10015,Baja,73,2023-01-31,167,181,760,8804,10775,1971
2856,1632,1287,611,5322,1031,17108,Media-Baja,74,2023-01-31,287,551,4864,13577,21972,8395
4783,2618,2544,973,6946,3273,33695,Media-Alta,75,2023-01-31,564,955,8790,22656,42485,19829
3199,1907,1187,548,4938,1283,17167,Media-Baja,76,2023-01-31,276,532,4697,13870,21864,7994
3071,1785,1180,611,6005,1690,16648,Media-Baja,77,2023-01-31,259,598,4078,15199,20726,5527
4017,3668,2612,1093,6974,2827,33842,Media-Alta,79,2023-01-31,561,984,9012,22736,42854,20118
4641,3036,2049,1393,5766,2794,39001,Media-Alta,80,2023-01-31,620,712,9628,21011,48629,27618
2988,1847,1151,526,5393,1545,19631,Media-Baja,81,2023-01-31,298,611,4348,14359,23979,9620
1306,1038,426,265,4183,617,10638,Baja,82,2023-01-31,158,162,932,8155,11570,3415
1595,1001,483,251,3483,653,9934,Baja,83,2023-01-31,195,182,697,7843,10631,2788
2975,1645,1240,587,5473,1574,16905,Media-Baja,84,2023-01-31,272,598,5274,14364,22179,7815
1420,894,521,233,4234,842,9052,Baja,85,2023-01-31,183,182,725,8509,9777,1268
1573,685,390,222,4493,817,9508,Baja,86,2023-01-31,159,211,806,8550,10314,1764
3546,1737,1151,589,5340,1593,15702,Media-Baja,87,2023-01-31,260,593,5149,14809,20851,6042
2752,2082,1174,521,6260,1485,16849,Media-Baja,88,2023-01-31,278,568,5257,15120,22106,6986
1346,1043,376,241,3859,881,9751,Baja,89,2023-01-31,167,183,824,8096,10575,2479
1396,967,383,272,4004,676,8109,Baja,90,2023-01-31,197,177,971,8072,9080,1008
3089,1461,1289,593,5521,1198,17090,Media-Baja,91,2023-01-31,346,710,4507,14207,21597,7390
4150,3451,2781,1407,6634,3089,36538,Media-Alta,92,2023-01-31,544,889,8603,22945,45141,22196
3029,1994,1215,675,6639,1470,17538,Media-Baja,93,2023-01-31,257,566,5458,15845,22996,7151
2895,1812,1372,640,5360,1571,16219,Media-Baja,94,2023-01-31,284,587,4636,14521,20855,6334
3856,1722,1193,651,5517,1773,20809,Media-Baja,95,2023-01-31,288,645,5129,15645,25938,10293
1648,928,433,271,4676,799,9711,Baja,96,2023-01-31,221,191,703,9167,10414,1247
3109,1817,1357,512,4430,1461,16953,Media-Baja,97,2023-01-31,322,580,4418,13588,21371,7783
1383,847,411,210,3700,670,10244,Baja,98,2023-01-31,159,198,910,7578,11154,3576
3187,1692,1150,592,5672,1491,17774,Media-Baja,99,2023-01-31,259,579,5120,14622,22894,8272
4483,3214,2176,1209,6865,2848,28868,Media-Alta,0,2023-02-28,507,879,6747,22181,35615,13434
1340,967,464,203,4190,682,8389,Baja,1,2023-02-28,162,161,853,8169,9242,1073
3144,1556,995,625,5690,1392,16474,Media-Baja,2,2023-02-28,289,549,4978,14240,21452,7212
4802,3002,2567,1215,5401,3412,37489,Media-Alta,3,2023-02-28,552,841,7469,21792,44958,23166
1541,947,359,201,3714,686,11385,Baja,4,2023-02-28,185,181,782,7814,12167,4353
3121,1938,1226,570,4867,1459,17378,Media-Baja,5,2023-02-28,280,653,4772,14114,22150,8036
2804,1750,1079,524,5620,1892,18170,Media-Baja,6,2023-02-28,305,583,4328,14557,22498,7941
5197,4521,3387,2558,9859,5255,97334,Alta,7,2023-02-28,6021,6170,17240,42968,114574,71606
4910,2979,2933,1267,8687,3085,37345,Media-Alta,8,2023-02-28,567,911,9665,25339,47010,21671
5194,3744,3720,2323,9526,5124,89084,Alta,9,2023-02-28,5672,5545,14962,40848,104046,63198
3024,1678,1386,677,5992,1527,19740,Media-Baja,10,2023-02-28,308,656,4559,15248,24299,9051
2640,1811,1372,561,5814,1555,16812,Media-Baja,11,2023-02-28,329,727,5831,14809,22643,7834
3327,1819,1226,698,6093,1593,18256,Media-Baja,12,2023-02-28,288,615,4506,15659,22762,7103
4510,3929,2553,1184,6260,3065,39441,Media-Alta,13,2023-02-28,670,1048,8236,23219,47677,24458
3139,1845,1097,550,6196,1515,15707,Media-Baja,14,2023-02-28,318,661,5279,15321,20986,5665
1579,681,455,229,4648,729,8536,Baja,15,2023-02-28,176,198,896,8695,9432,737
2753,1752,1288,677,6208,1563,16548,Media-Baja,16,2023-02-28,257,639,5684,15137,22232,7095
3138,1858,1089,625,5168,1324,17896,Media-Baja,17,2023-02-28,302,540,4693,14044,22589,8545
3379,1638,1030,537,4869,1280,20133,Media-Baja,18,2023-02-28,319,626,4759,13678,24892,11214
3267,1686,1135,591,6255,1514,17828,Media-Baja,19,2023-02-28,290,656,5829,15394,23657,8263
2924,1614,986,608,5350,1486,20302,Media-Baja,20,2023-02-28,370,593,4393,13931,24695,10764
4295,3252,2347,1364,6506,3388,33499,Media-Alta,21,2023-02-28,557,906,8675,22615,42174,19559
5318,4280,2392,1116,5572,3767,40793,Media-Alta,22,2023-02-28,518,908,6853,23871,47646,23775
2674,1619,1229,589,5382,1881,19674,Media-Baja,23,2023-02-28,313,514,4693,14201,24367,10166
1619,955,430,195,3674,634,9841,Baja,24,2023-02-28,187,141,917,7835,10758,2923
6557,5321,4433,1878,10719,5617,72411,Alta,25,2023-02-28,6244,4717,16240,45486,88651,43165
4816,3590,2786,1384,6748,3127,32629,Media-Alta,26,2023-02-28,735,877,8857,24063,41486,17423
1632,932,418,259,3620,744,9347,Baja,27,2023-02-28,188,169,784,7962,10131,2169
4673,3297,2305,1147,6690,3201,44571,Media-Alta,28,2023-02-28,646,864,8563,22823,53134,30311
1375,818,412,260,4297,794,10196,Baja,29,2023-02-28,211,176,906,8343,11102,2759
2863,1686,1239,512,4674,1747,18662,Media-Baja,30,2023-02-28,292,650,5298,13663,23960,10297
3924,4183,2282,1322,7220,2941,33308,Media-Alta,31,2023-02-28,578,1051,5935,23501,39243,15742
1718,960,426,272,4536,613,9280,Baja,32,2023-02-28,183,185,909,8893,10189,1296
6425,5225,3534,2024,10345,5082,71620,Alta,33,2023-02-28,5938,5108,17569,43681,89189,45508
2571,1844,1174,583,3963,1172,19342,Media-Baja,34,2023-02-28,298,549,4903,12154,24245,12091
2955,1978,1244,534,5338,1168,17681,Media-Baja,35,2023-02-28,280,592,4592,14089,22273,8184
2941,1791,968,645,4268,1458,17959,Media-Baja,36,2023-02-28,306,502,4835,12879,22794,9915
2930,1513,1247,688,5215,1508,18258,Media-Baja,37,2023-02-28,276,538,5359,13915,23617,9702
2544,1931,1074,507,5953,1566,17673,Media-Baja,38,2023-02-28,300,646,5649,14521,23322,8801
7364,5052,3483,2300,9560,4486,88948,Alta,39,2023-02-28,6103,5865,19669,44213,108617,64404
5546,3715,4192,1997,10640,4975,83884,Alta,40,2023-02-28,6383,5973,14975,43421,98859,55438
6140,4767,3465,2257,12219,4774,80468,Alta,41,2023-02-28,5886,4950,15747,44458,96215,51757
4631,2996,2378,1393,6170,2737,35663,Media-Alta,42,2023-02-28,528,704,7865,21537,43528,21991
6510,4774,3659,2222,8872,4447,94901,Alta,43,2023-02-28,6024,5973,18988,42481,113889,71408
7468,5099,4636,1913,10089,4994,78206,Alta,44,2023-02-28,6244,5614,16817,46057,95023,48966
4053,3213,2116,1053,6930,3037,35307,Media-Alta,45,2023-02-28,668,1047,6387,22117,41694,19577
4213,3303,2184,1497,6266,2925,33114,Media-Alta,46,2023-02-28,591,828,6737,21807,39851,18044
2793,1758,1215,556,5006,1663,17726,Media-Baja,47,2023-02-28,351,561,4409,13903,22135,8232
2699,1672,1282,617,4707,1311,17175,Media-Baja,48,2023-02-28,304,578,4364,13170,21539,8369
3180,2038,941,480,6115,1773,18621,Media-Baja,49,2023-02-28,294,626,4931,15447,23552,8105
3138,2097,1039,567,5905,1484,19791,Media-Baja,50,2023-02-28,318,744,4311,15292,24102,8810
1550,877,363,229,3972,681,10596,Baja,51,2023-02-28,201,158,913,8031,11509,3478
4404,3571,2219,1012,5723,2979,39592,Media-Alta,52,2023-02-28,687,734,8186,21329,47778,26449
1537,998,399,209,4030,759,9845,Baja,53,2023-02-28,167,204,817,8303,10662,2359
4896,3184,2586,1291,8108,2562,35904,Media-Alta,54,2023-02-28,688,871,6252,24186,42156,17970
3044,1821,1117,631,4624,1544,19680,Media-Baja,55,2023-02-28,294,589,5353,13664,25033,11369
1555,795,405,276,4177,717,10002,Baja,56,2023-02-28,168,192,727,8285,10729,2444
3007,2019,1227,509,4887,1178,17376,Media-Baja,57,2023-02-28,299,623,5823,13749,23199,9450
2774,2202,1122,579,5426,1495,19395,Media-Baja,58,2023-02-28,280,552,4976,14430,24371,9941
3719,2970,2446,1111,5809,2985,37559,Media-Alta,59,2023-02-28,611,917,8271,20568,45830,25262
2930,1739,1232,802,5415,1416,17555,Media-Baja,60,2023-02-28,306,614,4256,14454,21811,7357
2412,1821,1446,716,5272,1353,16786,Media-Baja,61,2023-02-28,349,662,4124,14031,20910,6879
3984,3540,2297,1288,6779,2768,31104,Media-Alta,62,2023-02-28,603,771,6481,22030,37585,15555
2982,1859,1250,610,6265,1560,16978,Media-Baja,63,2023-02-28,260,586,5390,15372,22368,6996
4338,3141,2045,1077,6116,3227,28781,Media-Alta,64,2023-02-28,723,819,7381,21486,36162,14676
5499,3358,2818,1137,7987,2369,36860,Media-Alta,65,2023-02-28,573,884,8134,24625,44994,20369
4016,3558,2347,1190,5783,3320,37181,Media-Alta,66,2023-02-28,577,986,6942,21777,44123,22346
5087,3755,2651,1245,7351,2723,33611,Media-Alta,67,2023-02-28,622,787,8258,24221,41869,17648
1452,855,397,242,4719,760,10857,Baja,69,2023-02-28,233,194,929,8852,11786,2934
2965,2059,1335,596,5029,1685,15767,Media-Baja,70,2023-02-28,301,608,4957,14578,20724,6146
6128,4643,3785,2360,9121,4008,75781,Alta,71,2023-02-28,7491,6409,16326,43945,92107,48162
1505,1036,399,247,4012,760,10174,Baja,72,2023-02-28,191,188,907,8338,11081,2743
1637,881,506,250,4458,724,10015,Baja,73,2023-02-28,185,176,856,8817,10871,2054
2856,1632,1287,611,5322,1031,17108,Media-Baja,74,2023-02-28,305,631,5440,13675,22548,8873
4783,2618,2544,973,6946,3273,33695,Media-Alta,75,2023-02-28,658,823,7243,22618,40938,18320
3199,1907,1187,548,4938,1283,17167,Media-Baja,76,2023-02-28,322,668,4485,14052,21652,7600
3071,1785,1180,611,6005,1690,16648,Media-Baja,77,2023-02-28,338,626,4138,15306,20786,5480
4017,3668,2612,1093,6974,2827,33842,Media-Alta,79,2023-02-28,579,937,8259,22707,42101,19394
4641,3036,2049,1393,5766,2794,39001,Media-Alta,80,2023-02-28,628,816,7951,21123,46952,25829
2988,1847,1151,526,5393,1545,19631,Media-Baja,81,2023-02-28,280,721,6113,14451,25744,11293
1306,1038,426,265,4183,617,10638,Baja,82,2023-02-28,205,185,714,8225,11352,3127
1595,1001,483,251,3483,653,9934,Baja,83,2023-02-28,181,152,820,7799,10754,2955
2975,1645,1240,587,5473,1574,16905,Media-Baja,84,2023-02-28,286,510,4880,14290,21785,7495
1420,894,521,233,4234,842,9052,Baja,85,2023-02-28,189,165,954,8498,10006,1508
1573,685,390,222,4493,817,9508,Baja,86,2023-02-28,182,197,801,8559,10309,1750
3546,1737,1151,589,5340,1593,15702,Media-Baja,87,2023-02-28,282,617,4522,14855,20224,5369
2752,2082,1174,521,6260,1485,16849,Media-Baja,88,2023-02-28,345,599,5674,15218,22523,7305
1346,1043,376,241,3859,881,9751,Baja,89,2023-02-28,191,174,869,8111,10620,2509
1396,967,383,272,4004,676,8109,Baja,90,2023-02-28,189,176,741,8063,8850,787
3089,1461,1289,593,5521,1198,17090,Media-Baja,91,2023-02-28,371,597,5795,14119,22885,8766
4150,3451,2781,1407,6634,3089,36538,Media-Alta,92,2023-02-28,579,907,7838,22998,44376,21378
3029,1994,1215,675,6639,1470,17538,Media-Baja,93,2023-02-28,274,498,4874,15794,22412,6618
2895,1812,1372,640,5360,1571,16219,Media-Baja,94,2023-02-28,242,712,3980,14604,20199,5595
3856,1722,1193,651,5517,1773,20809,Media-Baja,95,2023-02-28,325,656,4702,15693,25511,9818
1648,928,433,271,4676,799,9711,Baja,96,2023-02-28,170,181,698,9106,10409,1303
3109,1817,1357,512,4430,1461,16953,Media-Baja,97,2023-02-28,363,673,4253,13722,21206,7484
1383,847,411,210,3700,670,10244,Baja,98,2023-02-28,158,177,863,7556,11107,3551
3187,1692,1150,592,5672,1491,17774,Media-Baja,99,2023-02-28,284,512,4691,14580,22465,7885
4483,3214,2176,1209,6865,2848,28868,Media-Alta,0,2023-03-31,583,961,8488,22339,37356,15017
1340,967,464,203,4190,682,8389,Baja,1,2023-03-31,186,218,891,8250,9280,1030
3144,1556,995,625,5690,1392,16474,Media-Baja,2,2023-03-31,320,615,4903,14337,21377,7040
4802,3002,2567,1215,5401,3412,37489,Media-Alta,3,2023-03-31,595,985,8282,21979,45771,23792
1541,947,359,201,3714,686,11385,Baja,4,2023-03-31,149,201,806,7798,12191,4393
3121,1938,1226,570,4867,1459,17378,Media-Baja,5,2023-03-31,244,554,5636,13979,23014,9035
2804,1750,1079,524,5620,1892,18170,Media-Baja,6,2023-03-31,298,611,4387,14578,22557,7979
5197,4521,3387,2558,9859,5255,97334,Alta,7,2023-03-31,5610,5731,14671,42118,112005,69887
4910,2979,2933,1267,8687,3085,37345,Media-Alta,8,2023-03-31,669,804,8012,25334,45357,20023
5194,3744,3720,2323,9526,5124,89084,Alta,9,2023-03-31,6997,5679,15276,42307,104360,62053
3024,1678,1386,677,5992,1527,19740,Media-Baja,10,2023-03-31,272,544,5327,15100,25067,9967
2640,1811,1372,561,5814,1555,16812,Media-Baja,11,2023-03-31,393,667,5571,14813,22383,7570
3327,1819,1226,698,6093,1593,18256,Media-Baja,12,2023-03-31,258,581,5371,15595,23627,8032
4510,3929,2553,1184,6260,3065,39441,Media-Alta,13,2023-03-31,551,843,8076,22895,47517,24622
3139,1845,1097,550,6196,1515,15707,Media-Baja,14,2023-03-31,281,641,4882,15264,20589,5325
1579,681,455,229,4648,729,8536,Baja,15,2023-03-31,158,170,983,8649,9519,870
2753,1752,1288,677,6208,1563,16548,Media-Baja,16,2023-03-31,305,608,4063,15154,20611,5457
3138,1858,1089,625,5168,1324,17896,Media-Baja,17,2023-03-31,308,619,4765,14129,22661,8532
3379,1638,1030,537,4869,1280,20133,Media-Baja,18,2023-03-31,308,626,5132,13667,25265,11598
3267,1686,1135,591,6255,1514,17828,Media-Baja,19,2023-03-31,251,572,5357,15271,23185,7914
2924,1614,986,608,5350,1486,20302,Media-Baja,20,2023-03-31,314,566,4770,13848,25072,11224
4295,3252,2347,1364,6506,3388,33499,Media-Alta,21,2023-03-31,566,1020,9741,22738,43240,20502
5318,4280,2392,1116,5572,3767,40793,Media-Alta,22,2023-03-31,639,949,6713,24033,47506,23473
2674,1619,1229,589,5382,1881,19674,Media-Baja,23,2023-03-31,332,604,4029,14310,23703,9393
1619,955,430,195,3674,634,9841,Baja,24,2023-03-31,150,176,937,7833,10778,2945
6557,5321,4433,1878,10719,5617,72411,Alta,25,2023-03-31,6594,5992,15931,47111,88342,41231
4816,3590,2786,1384,6748,3127,32629,Media-Alta,26,2023-03-31,546,798,8633,23795,41262,17467
1632,932,418,259,3620,744,9347,Baja,27,2023-03-31,175,176,869,7956,10216,2260
4673,3297,2305,1147,6690,3201,44571,Media-Alta,28,2023-03-31,586,778,8086,22677,52657,29980
1375,818,412,260,4297,794,10196,Baja,29,2023-03-31,177,186,726,8319,10922,2603
2863,1686,1239,512,4674,1747,18662,Media-Baja,30,2023-03-31,290,656,5306,13667,23968,10301
3924,4183,2282,1322,7220,2941,33308,Media-Alta,31,2023-03-31,580,983,5895,23435,39203,15768
1718,960,426,272,4536,613,9280,Baja,32,2023-03-31,163,177,700,8865,9980,1115
6425,5225,3534,2024,10345,5082,71620,Alta,33,2023-03-31,6069,5093,18869,43797,90489,46692
2571,1844,1174,583,3963,1172,19342,Media-Baja,34,2023-03-31,312,577,5100,12196,24442,12246
2955,1978,1244,534,5338,1168,17681,Media-Baja,35,2023-03-31,268,607,4985,14092,22666,8574
2941,1791,968,645,4268,1458,17959,Media-Baja,36,2023-03-31,314,628,5704,13013,23663,10650
2930,1513,1247,688,5215,1508,18258,Media-Baja,37,2023-03-31,294,693,5670,14088,23928,9840
2544,1931,1074,507,5953,1566,17673,Media-Baja,38,2023-03-31,317,597,5335,14489,23008,8519
7364,5052,3483,2300,9560,4486,88948,Alta,39,2023-03-31,6009,6214,15494,44468,104442,59974
5546,3715,4192,1997,10640,4975,83884,Alta,40,2023-03-31,7184,5845,14108,44094,97992,53898
6140,4767,3465,2257,12219,4774,80468,Alta,41,2023-03-31,6908,5791,15288,46321,95756,49435
4631,2996,2378,1393,6170,2737,35663,Media-Alta,42,2023-03-31,683,845,7801,21833,43464,21631
6510,4774,3659,2222,8872,4447,94901,Alta,43,2023-03-31,5333,5748,17290,41565,112191,70626
7468,5099,4636,1913,10089,4994,78206,Alta,44,2023-03-31,5422,5266,16427,44887,94633,49746
4053,3213,2116,1053,6930,3037,35307,Media-Alta,45,2023-03-31,599,813,7487,21814,42794,20980
4213,3303,2184,1497,6266,2925,33114,Media-Alta,46,2023-03-31,514,990,6837,21892,39951,18059
2793,1758,1215,556,5006,1663,17726,Media-Baja,47,2023-03-31,281,592,4315,13864,22041,8177
2699,1672,1282,617,4707,1311,17175,Media-Baja,48,2023-03-31,338,519,4113,13145,21288,8143
3180,2038,941,480,6115,1773,18621,Media-Baja,49,2023-03-31,284,589,5106,15400,23727,8327
3138,2097,1039,567,5905,1484,19791,Media-Baja,50,2023-03-31,325,478,4960,15033,24751,9718
1550,877,363,229,3972,681,10596,Baja,51,2023-03-31,181,186,859,8039,11455,3416
4404,3571,2219,1012,5723,2979,39592,Media-Alta,52,2023-03-31,663,900,9885,21471,49477,28006
1537,998,399,209,4030,759,9845,Baja,53,2023-03-31,150,165,811,8247,10656,2409
4896,3184,2586,1291,8108,2562,35904,Media-Alta,54,2023-03-31,581,908,7966,24116,43870,19754
3044,1821,1117,631,4624,1544,19680,Media-Baja,55,2023-03-31,254,531,5414,13566,25094,11528
1555,795,405,276,4177,717,10002,Baja,56,2023-03-31,164,176,861,8265,10863,2598
3007,2019,1227,509,4887,1178,17376,Media-Baja,57,2023-03-31,294,557,4545,13678,21921,8243
2774,2202,1122,579,5426,1495,19395,Media-Baja,58,2023-03-31,304,489,4831,14391,24226,9835
3719,2970,2446,1111,5809,2985,37559,Media-Alta,59,2023-03-31,622,931,7375,20593,44934,24341
2930,1739,1232,802,5415,1416,17555,Media-Baja,60,2023-03-31,299,586,4687,14419,22242,7823
2412,1821,1446,716,5272,1353,16786,Media-Baja,61,2023-03-31,326,623,4360,13969,21146,7177
3984,3540,2297,1288,6779,2768,31104,Media-Alta,62,2023-03-31,671,881,8097,22208,39201,16993
2982,1859,1250,610,6265,1560,16978,Media-Baja,63,2023-03-31,257,620,4819,15403,21797,6394
4338,3141,2045,1077,6116,3227,28781,Media-Alta,64,2023-03-31,546,885,7908,21375,36689,15314
5499,3358,2818,1137,7987,2369,36860,Media-Alta,65,2023-03-31,675,986,8364,24829,45224,20395
4016,3558,2347,1190,5783,3320,37181,Media-Alta,66,2023-03-31,709,855,7930,21778,45111,23333
5087,3755,2651,1245,7351,2723,33611,Media-Alta,67,2023-03-31,468,679,9370,23959,42981,19022
1452,855,397,242,4719,760,10857,Baja,69,2023-03-31,185,175,729,8785,11586,2801
2965,2059,1335,596,5029,1685,15767,Media-Baja,70,2023-03-31,307,570,4709,14546,20476,5930
6128,4643,3785,2360,9121,4008,75781,Alta,71,2023-03-31,6855,5503,16684,42403,92465,50062
1505,1036,399,247,4012,760,10174,Baja,72,2023-03-31,155,180,967,8294,11141,2847
1637,881,506,250,4458,724,10015,Baja,73,2023-03-31,201,153,633,8810,10648,1838
2856,1632,1287,611,5322,1031,17108,Media-Baja,74,2023-03-31,312,706,4965,13757,22073,8316
4783,2618,2544,973,6946,3273,33695,Media-Alta,75,2023-03-31,662,947,9164,22746,42859,20113
3199,1907,1187,548,4938,1283,17167,Media-Baja,76,2023-03-31,316,557,5802,13935,22969,9034
3071,1785,1180,611,6005,1690,16648,Media-Baja,77,2023-03-31,306,659,4952,15307,21600,6293
4017,3668,2612,1093,6974,2827,33842,Media-Alta,79,2023-03-31,501,899,7512,22591,41354,18763
4641,3036,2049,1393,5766,2794,39001,Media-Alta,80,2023-03-31,591,936,8619,21206,47620,26414
2988,1847,1151,526,5393,1545,19631,Media-Baja,81,2023-03-31,274,536,5109,14260,24740,10480
1306,1038,426,265,4183,617,10638,Baja,82,2023-03-31,177,165,876,8177,11514,3337
1595,1001,483,251,3483,653,9934,Baja,83,2023-03-31,156,195,894,7817,10828,3011
2975,1645,1240,587,5473,1574,16905,Media-Baja,84,2023-03-31,306,614,3613,14414,20518,6104
1420,894,521,233,4234,842,9052,Baja,85,2023-03-31,162,211,694,8517,9746,1229
1573,685,390,222,4493,817,9508,Baja,86,2023-03-31,150,157,952,8487,10460,1973
3546,1737,1151,589,5340,1593,15702,Media-Baja,87,2023-03-31,257,617,4269,14830,19971,5141
2752,2082,1174,521,6260,1485,16849,Media-Baja,88,2023-03-31,301,579,4796,15154,21645,6491
1346,1043,376,241,3859,881,9751,Baja,89,2023-03-31,157,175,909,8078,10660,2582
1396,967,383,272,4004,676,8109,Baja,90,2023-03-31,189,177,832,8064,8941,877
3089,1461,1289,593,5521,1198,17090,Media-Baja,91,2023-03-31,292,586,3975,14029,21065,7036
4150,3451,2781,1407,6634,3089,36538,Media-Alta,92,2023-03-31,661,818,8600,22991,45138,22147
3029,1994,1215,675,6639,1470,17538,Media-Baja,93,2023-03-31,331,599,5059,15952,22597,6645
2895,1812,1372,640,5360,1571,16219,Media-Baja,94,2023-03-31,281,564,5243,14495,21462,6967
3856,1722,1193,651,5517,1773,20809,Media-Baja,95,2023-03-31,302,585,3798,15599,24607,9008
1648,928,433,271,4676,799,9711,Baja,96,2023-03-31,155,193,841,9103,10552,1449
3109,1817,1357,512,4430,1461,16953,Media-Baja,97,2023-03-31,282,640,4832,13608,21785,8177
1383,847,411,210,3700,670,10244,Baja,98,2023-03-31,182,173,842,7576,11086,3510
3187,1692,1150,592,5672,1491,17774,Media-Baja,99,2023-03-31,342,644,5871,14770,23645,8875
4483,3214,2176,1209,6865,2848,28868,Media-Alta,0,2023-04-30,552,805,8183,22152,37051,14899
1340,967,464,203,4190,682,8389,Baja,1,2023-04-30,175,173,817,8194,9206,1012
3144,1556,995,625,5690,1392,16474,Media-Baja,2,2023-04-30,266,667,5051,14335,21525,7190
4802,3002,2567,1215,5401,3412,37489,Media-Alta,3,2023-04-30,637,781,8698,21817,46187,24370
1541,947,359,201,3714,686,11385,Baja,4,2023-04-30,165,140,956,7753,12341,4588
3121,1938,1226,570,4867,1459,17378,Media-Baja,5,2023-04-30,269,608,5053,14058,22431,8373
2804,1750,1079,524,5620,1892,18170,Media-Baja,6,2023-04-30,306,574,5875,14549,24045,9496
5197,4521,3387,2558,9859,5255,97334,Alta,7,2023-04-30,5268,6207,17927,42252,115261,73009
4910,2979,2933,1267,8687,3085,37345,Media-Alta,8,2023-04-30,631,857,7088,25349,44433,19084
5194,3744,3720,2323,9526,5124,89084,Alta,9,2023-04-30,6107,4539,17035,40277,106119,65842
3024,1678,1386,677,5992,1527,19740,Media-Baja,10,2023-04-30,324,626,5402,15234,25142,9908
2640,1811,1372,561,5814,1555,16812,Media-Baja,11,2023-04-30,280,558,4991,14591,21803,7212
3327,1819,1226,698,6093,1593,18256,Media-Baja,12,2023-04-30,248,566,5608,15570,23864,8294
4510,3929,2553,1184,6260,3065,39441,Media-Alta,13,2023-04-30,544,866,7974,22911,47415,24504
3139,1845,1097,550,6196,1515,15707,Media-Baja,14,2023-04-30,314,619,5284,15275,20991,5716
1579,681,455,229,4648,729,8536,Baja,15,2023-04-30,192,182,880,8695,9416,721
2753,1752,1288,677,6208,1563,16548,Media-Baja,16,2023-04-30,332,683,4553,15256,21101,5845
3138,1858,1089,625,5168,1324,17896,Media-Baja,17,2023-04-30,289,587,4741,14078,22637,8559
3379,1638,1030,537,4869,1280,20133,Media-Baja,18,2023-04-30,282,615,4458,13630,24591,10961
3267,1686,1135,591,6255,1514,17828,Media-Baja,19,2023-04-30,252,549,6078,15249,23906,8657
2924,1614,986,608,5350,1486,20302,Media-Baja,20,2023-04-30,341,537,5493,13846,25795,11949
4295,3252,2347,1364,6506,3388,33499,Media-Alta,21,2023-04-30,564,914,7147,22630,40646,18016
5318,4280,2392,1116,5572,3767,40793,Media-Alta,22,2023-04-30,637,1031,6984,24113,47777,23664
2674,1619,1229,589,5382,1881,19674,Media-Baja,23,2023-04-30,311,614,5151,14299,24825,10526
1619,955,430,195,3674,634,9841,Baja,24,2023-04-30,194,210,919,7911,10760,2849
6557,5321,4433,1878,10719,5617,72411,Alta,25,2023-04-30,6051,6705,16056,47281,88467,41186
4816,3590,2786,1384,6748,3127,32629,Media-Alta,26,2023-04-30,632,724,8242,23807,40871,17064
1632,932,418,259,3620,744,9347,Baja,27,2023-04-30,203,149,812,7957,10159,2202
4673,3297,2305,1147,6690,3201,44571,Media-Alta,28,2023-04-30,484,952,8191,22749,52762,30013
1375,818,412,260,4297,794,10196,Baja,29,2023-04-30,201,168,1003,8325,11199,2874
2863,1686,1239,512,4674,1747,18662,Media-Baja,30,2023-04-30,283,583,4447,13587,23109,9522
3924,4183,2282,1322,7220,2941,33308,Media-Alta,31,2023-04-30,525,828,9381,23225,42689,19464
1718,960,426,272,4536,613,9280,Baja,32,2023-04-30,205,156,893,8886,10173,1287
6425,5225,3534,2024,10345,5082,71620,Alta,33,2023-04-30,7110,4911,15545,44656,87165,42509
2571,1844,1174,583,3963,1172,19342,Media-Baja,34,2023-04-30,336,595,4898,12238,24240,12002
2955,1978,1244,534,5338,1168,17681,Media-Baja,35,2023-04-30,295,546,4607,14058,22288,8230
2941,1791,968,645,4268,1458,17959,Media-Baja,36,2023-04-30,341,646,4992,13058,22951,9893
2930,1513,1247,688,5215,1508,18258,Media-Baja,37,2023-04-30,324,562,5035,13987,23293,9306
2544,1931,1074,507,5953,1566,17673,Media-Baja,38,2023-04-30,264,632,5819,14471,23492,9021
7364,5052,3483,2300,9560,4486,88948,Alta,39,2023-04-30,6231,5404,12221,43880,101169,57289
5546,3715,4192,1997,10640,4975,83884,Alta,40,2023-04-30,6545,5560,16054,43170,99938,56768
6140,4767,3465,2257,12219,4774,80468,Alta,41,2023-04-30,5641,6159,17033,45422,97501,52079
4631,2996,2378,1393,6170,2737,35663,Media-Alta,42,2023-04-30,472,906,8641,21683,44304,22621
6510,4774,3659,2222,8872,4447,94901,Alta,43,2023-04-30,6530,5803,17213,42817,112114,69297
7468,5099,4636,1913,10089,4994,78206,Alta,44,2023-04-30,6652,5968,15884,46819,94090,47271
4053,3213,2116,1053,6930,3037,35307,Media-Alta,45,2023-04-30,704,1122,7818,22228,43125,20897
4213,3303,2184,1497,6266,2925,33114,Media-Alta,46,2023-04-30,621,772,7903,21781,41017,19236
2793,1758,1215,556,5006,1663,17726,Media-Baja,47,2023-04-30,239,629,5490,13859,23216,9357
2699,1672,1282,617,4707,1311,17175,Media-Baja,48,2023-04-30,334,599,4891,13221,22066,8845
3180,2038,941,480,6115,1773,18621,Media-Baja,49,2023-04-30,318,558,4336,15403,22957,7554
3138,2097,1039,567,5905,1484,19791,Media-Baja,50,2023-04-30,236,586,4721,15052,24512,9460
1550,877,363,229,3972,681,10596,Baja,51,2023-04-30,157,195,837,8024,11433,3409
4404,3571,2219,1012,5723,2979,39592,Media-Alta,52,2023-04-30,596,1087,8199,21591,47791,26200
1537,998,399,209,4030,759,9845,Baja,53,2023-04-30,175,146,739,8253,10584,2331
4896,3184,2586,1291,8108,2562,35904,Media-Alta,54,2023-04-30,512,906,9246,24045,45150,21105
3044,1821,1117,631,4624,1544,19680,Media-Baja,55,2023-04-30,284,608,4202,13673,23882,10209
1555,795,405,276,4177,717,10002,Baja,56,2023-04-30,147,173,683,8245,10685,2440
3007,2019,1227,509,4887,1178,17376,Media-Baja,57,2023-04-30,246,504,5140,13577,22516,8939
2774,2202,1122,579,5426,1495,19395,Media-Baja,58,2023-04-30,258,507,4221,14363,23616,9253
3719,2970,2446,1111,5809,2985,37559,Media-Alta,59,2023-04-30,640,887,6713,20567,44272,23705
2930,1739,1232,802,5415,1416,17555,Media-Baja,60,2023-04-30,280,688,4656,14502,22211,7709
2412,1821,1446,716,5272,1353,16786,Media-Baja,61,2023-04-30,290,607,5224,13917,22010,8093
3984,3540,2297,1288,6779,2768,31104,Media-Alta,62,2023-04-30,620,890,8062,22166,39166,17000
2982,1859,1250,610,6265,1560,16978,Media-Baja,63,2023-04-30,293,604,3657,15423,20635,5212
4338,3141,2045,1077,6116,3227,28781,Media-Alta,64,2023-04-30,613,918,7641,21475,36422,14947
5499,3358,2818,1137,7987,2369,36860,Media-Alta,65,2023-04-30,599,778,7927,24545,44787,20242
4016,3558,2347,1190,5783,3320,37181,Media-Alta,66,2023-04-30,569,902,9303,21685,46484,24799
5087,3755,2651,1245,7351,2723,33611,Media-Alta,67,2023-04-30,521,837,7178,24170,40789,16619
1452,855,397,242,4719,760,10857,Baja,69,2023-04-30,177,157,989,8759,11846,3087
2965,2059,1335,596,5029,1685,15767,Media-Baja,70,2023-04-30,332,664,5635,14665,21402,6737
6128,4643,3785,2360,9121,4008,75781,Alta,71,2023-04-30,6237,5217,16775,41499,92556,51057
1505,1036,399,247,4012,760,10174,Baja,72,2023-04-30,197,140,946,8296,11120,2824
1637,881,506,250,4458,724,10015,Baja,73,2023-04-30,146,170,868,8772,10883,2111
2856,1632,1287,611,5322,1031,17108,Media-Baja,74,2023-04-30,296,653,4933,13688,22041,8353
4783,2618,2544,973,6946,3273,33695,Media-Alta,75,2023-04-30,592,828,8774,22557,42469,19912
3199,1907,1187,548,4938,1283,17167,Media-Baja,76,2023-04-30,379,592,6192,14033,23359,9326
3071,1785,1180,611,6005,1690,16648,Media-Baja,77,2023-04-30,283,584,4501,15209,21149,5940
4017,3668,2612,1093,6974,2827,33842,Media-Alta,79,2023-04-30,629,1102,8362,22922,42204,19282
4641,3036,2049,1393,5766,2794,39001,Media-Alta,80,2023-04-30,692,889,7042,21260,46043,24783
2988,1847,1151,526,5393,1545,19631,Media-Baja,81,2023-04-30,295,564,5480,14309,25111,10802
1306,1038,426,265,4183,617,10638,Baja,82,2023-04-30,185,195,778,8215,11416,3201
1595,1001,483,251,3483,653,9934,Baja,83,2023-04-30,174,180,834,7820,10768,2948
2975,1645,1240,587,5473,1574,16905,Media-Baja,84,2023-04-30,311,522,4807,14327,21712,7385
1420,894,521,233,4234,842,9052,Baja,85,2023-04-30,145,173,798,8462,9850,1388
1573,685,390,222,4493,817,9508,Baja,86,2023-04-30,169,200,840,8549,10348,1799
3546,1737,1151,589,5340,1593,15702,Media-Baja,87,2023-04-30,264,527,5087,14747,20789,6042
2752,2082,1174,521,6260,1485,16849,Media-Baja,88,2023-04-30,336,664,5111,15274,21960,6686
1346,1043,376,241,3859,881,9751,Baja,89,2023-04-30,157,185,759,8088,10510,2422
1396,967,383,272,4004,676,8109,Baja,90,2023-04-30,174,156,906,8028,9015,987
3089,1461,1289,593,5521,1198,17090,Media-Baja,91,2023-04-30,278,574,4892,14003,21982,7979
4150,3451,2781,1407,6634,3089,36538,Media-Alta,92,2023-04-30,780,1098,7771,23390,44309,20919
3029,1994,1215,675,6639,1470,17538,Media-Baja,93,2023-04-30,230,484,4491,15736,22029,6293
2895,1812,1372,640,5360,1571,16219,Media-Baja,94,2023-04-30,281,589,4896,14520,21115,6595
3856,1722,1193,651,5517,1773,20809,Media-Baja,95,2023-04-30,286,572,5487,15570,26296,10726
1648,928,433,271,4676,799,9711,Baja,96,2023-04-30,149,161,802,9065,10513,1448
3109,1817,1357,512,4430,1461,16953,Media-Baja,97,2023-04-30,326,679,4744,13691,21697,8006
1383,847,411,210,3700,670,10244,Baja,98,2023-04-30,200,159,696,7580,10940,3360
3187,1692,1150,592,5672,1491,17774,Media-Baja,99,2023-04-30,245,592,5660,14621,23434,8813
4483,3214,2176,1209,6865,2848,28868,Media-Alta,0,2023-05-31,544,991,6821,22330,35689,13359
1340,967,464,203,4190,682,8389,Baja,1,2023-05-31,137,194,788,8177,9177,1000
3144,1556,995,625,5690,1392,16474,Media-Baja,2,2023-05-31,296,627,5329,14325,21803,7478
4802,3002,2567,1215,5401,3412,37489,Media-Alta,3,2023-05-31,667,782,6482,21848,43971,22123
1541,947,359,201,3714,686,11385,Baja,4,2023-05-31,186,212,697,7846,12082,4236
3121,1938,1226,570,4867,1459,17378,Media-Baja,5,2023-05-31,300,545,4789,14026,22167,8141
2804,1750,1079,524,5620,1892,18170,Media-Baja,6,2023-05-31,301,510,4420,14480,22590,8110
5197,4521,3387,2558,9859,5255,97334,Alta,7,2023-05-31,4398,5636,17004,40811,114338,73527
4910,2979,2933,1267,8687,3085,37345,Media-Alta,8,2023-05-31,714,637,7574,25212,44919,19707
5194,3744,3720,2323,9526,5124,89084,Alta,9,2023-05-31,5863,5673,19746,41167,108830,67663
3024,1678,1386,677,5992,1527,19740,Media-Baja,10,2023-05-31,305,616,5023,15205,24763,9558
2640,1811,1372,561,5814,1555,16812,Media-Baja,11,2023-05-31,265,691,4548,14709,21360,6651
3327,1819,1226,698,6093,1593,18256,Media-Baja,12,2023-05-31,325,602,4502,15683,22758,7075
4510,3929,2553,1184,6260,3065,39441,Media-Alta,13,2023-05-31,542,860,9103,22903,48544,25641
3139,1845,1097,550,6196,1515,15707,Media-Baja,14,2023-05-31,257,622,5452,15221,21159,5938
1579,681,455,229,4648,729,8536,Baja,15,2023-05-31,185,207,863,8713,9399,686
2753,1752,1288,677,6208,1563,16548,Media-Baja,16,2023-05-31,278,640,4897,15159,21445,6286
3138,1858,1089,625,5168,1324,17896,Media-Baja,17,2023-05-31,276,640,5339,14118,23235,9117
3379,1638,1030,537,4869,1280,20133,Media-Baja,18,2023-05-31,275,560,4944,13568,25077,11509
3267,1686,1135,591,6255,1514,17828,Media-Baja,19,2023-05-31,317,625,3831,15390,21659,6269
2924,1614,986,608,5350,1486,20302,Media-Baja,20,2023-05-31,286,509,4179,13763,24481,10718
4295,3252,2347,1364,6506,3388,33499,Media-Alta,21,2023-05-31,589,900,8273,22641,41772,19131
5318,4280,2392,1116,5572,3767,40793,Media-Alta,22,2023-05-31,514,891,6123,23850,46916,23066
2674,1619,1229,589,5382,1881,19674,Media-Baja,23,2023-05-31,316,589,4267,14279,23941,9662
1619,955,430,195,3674,634,9841,Baja,24,2023-05-31,192,165,986,7864,10827,2963
6557,5321,4433,1878,10719,5617,72411,Alta,25,2023-05-31,5409,5696,20199,45630,92610,46980
4816,3590,2786,1384,6748,3127,32629,Media-Alta,26,2023-05-31,608,908,7046,23967,39675,15708
1632,932,418,259,3620,744,9347,Baja,27,2023-05-31,186,197,962,7988,10309,2321
4673,3297,2305,1147,6690,3201,44571,Media-Alta,28,2023-05-31,646,899,7488,22858,52059,29201
1375,818,412,260,4297,794,10196,Baja,29,2023-05-31,194,182,809,8332,11005,2673
2863,1686,1239,512,4674,1747,18662,Media-Baja,30,2023-05-31,300,528,5810,13549,24472,10923
3924,4183,2282,1322,7220,2941,33308,Media-Alta,31,2023-05-31,704,851,8737,23427,42045,18618
1718,960,426,272,4536,613,9280,Baja,32,2023-05-31,223,182,808,8930,10088,1158
6425,5225,3534,2024,10345,5082,71620,Alta,33,2023-05-31,6196,5284,16633,44115,88253,44138
2571,1844,1174,583,3963,1172,19342,Media-Baja,34,2023-05-31,351,628,4441,12286,23783,11497
2955,1978,1244,534,5338,1168,17681,Media-Baja,35,2023-05-31,298,564,5654,14079,23335,9256
2941,1791,968,645,4268,1458,17959,Media-Baja,36,2023-05-31,338,622,4785,13031,22744,9713
2930,1513,1247,688,5215,1508,18258,Media-Baja,37,2023-05-31,330,613,5470,14044,23728,9684
2544,1931,1074,507,5953,1566,17673,Media-Baja,38,2023-05-31,292,632,5373,14499,23046,8547
7364,5052,3483,2300,9560,4486,88948,Alta,39,2023-05-31,5539,5148,17609,42932,106557,63625
5546,3715,4192,1997,10640,4975,83884,Alta,40,2023-05-31,4970,5396,14669,41431,98553,57122
6140,4767,3465,2257,12219,4774,80468,Alta,41,2023-05-31,5889,5268,18699,44779,99167,54388
4631,2996,2378,1393,6170,2737,35663,Media-Alta,42,2023-05-31,669,794,8346,21768,44009,22241
6510,4774,3659,2222,8872,4447,94901,Alta,43,2023-05-31,5782,4486,20196,40752,115097,74345
7468,5099,4636,1913,10089,4994,78206,Alta,44,2023-05-31,5474,5741,17730,45414,95936,50522
4053,3213,2116,1053,6930,3037,35307,Media-Alta,45,2023-05-31,637,952,8264,21991,43571,21580
4213,3303,2184,1497,6266,2925,33114,Media-Alta,46,2023-05-31,604,905,7921,21897,41035,19138
2793,1758,1215,556,5006,1663,17726,Media-Baja,47,2023-05-31,342,573,5622,13906,23348,9442
2699,1672,1282,617,4707,1311,17175,Media-Baja,48,2023-05-31,250,570,5450,13108,22625,9517
3180,2038,941,480,6115,1773,18621,Media-Baja,49,2023-05-31,287,560,4899,15374,23520,8146
3138,2097,1039,567,5905,1484,19791,Media-Baja,50,2023-05-31,318,623,4694,15171,24485,9314
1550,877,363,229,3972,681,10596,Baja,51,2023-05-31,175,193,690,8040,11286,3246
4404,3571,2219,1012,5723,2979,39592,Media-Alta,52,2023-05-31,502,802,6968,21212,46560,25348
1537,998,399,209,4030,759,9845,Baja,53,2023-05-31,158,176,812,8266,10657,2391
4896,3184,2586,1291,8108,2562,35904,Media-Alta,54,2023-05-31,629,995,7438,24251,43342,19091
3044,1821,1117,631,4624,1544,19680,Media-Baja,55,2023-05-31,294,545,5546,13620,25226,11606
1555,795,405,276,4177,717,10002,Baja,56,2023-05-31,164,212,780,8301,10782,2481
3007,2019,1227,509,4887,1178,17376,Media-Baja,57,2023-05-31,338,610,4347,13775,21723,7948
2774,2202,1122,579,5426,1495,19395,Media-Baja,58,2023-05-31,268,581,5149,14447,24544,10097
3719,2970,2446,1111,5809,2985,37559,Media-Alta,59,2023-05-31,601,1050,7818,20691,45377,24686
2930,1739,1232,802,5415,1416,17555,Media-Baja,60,2023-05-31,316,527,5388,14377,22943,8566
2412,1821,1446,716,5272,1353,16786,Media-Baja,61,2023-05-31,278,758,4665,14056,21451,7395
3984,3540,2297,1288,6779,2768,31104,Media-Alta,62,2023-05-31,555,986,7416,22197,38520,16323
2982,1859,1250,610,6265,1560,16978,Media-Baja,63,2023-05-31,278,507,4977,15311,21955,6644
4338,3141,2045,1077,6116,3227,28781,Media-Alta,64,2023-05-31,675,901,8260,21520,37041,15521
5499,3358,2818,1137,7987,2369,36860,Media-Alta,65,2023-05-31,569,829,7112,24566,43972,19406
4016,3558,2347,1190,5783,3320,37181,Media-Alta,66,2023-05-31,706,1021,9328,21941,46509,24568
5087,3755,2651,1245,7351,2723,33611,Media-Alta,67,2023-05-31,491,829,7457,24132,41068,16936
1452,855,397,242,4719,760,10857,Baja,69,2023-05-31,176,165,849,8766,11706,2940
2965,2059,1335,596,5029,1685,15767,Media-Baja,70,2023-05-31,337,584,4562,14590,20329,5739
6128,4643,3785,2360,9121,4008,75781,Alta,71,2023-05-31,5195,5925,17767,41165,93548,52383
1505,1036,399,247,4012,760,10174,Baja,72,2023-05-31,173,189,877,8321,11051,2730
1637,881,506,250,4458,724,10015,Baja,73,2023-05-31,177,192,847,8825,10862,2037
2856,1632,1287,611,5322,1031,17108,Media-Baja,74,2023-05-31,282,793,4684,13814,21792,7978
4783,2618,2544,973,6946,3273,33695,Media-Alta,75,2023-05-31,542,811,8399,22490,42094,19604
3199,1907,1187,548,4938,1283,17167,Media-Baja,76,2023-05-31,296,690,6195,14048,23362,9314
3071,1785,1180,611,6005,1690,16648,Media-Baja,77,2023-05-31,323,592,4912,15257,21560,6303
4017,3668,2612,1093,6974,2827,33842,Media-Alta,79,2023-05-31,629,1057,8302,22877,42144,19267
4641,3036,2049,1393,5766,2794,39001,Media-Alta,80,2023-05-31,705,1151,8071,21535,47072,25537
2988,1847,1151,526,5393,1545,19631,Media-Baja,81,2023-05-31,252,610,4218,14312,23849,9537
1306,1038,426,265,4183,617,10638,Baja,82,2023-05-31,177,183,877,8195,11515,3320
1595,1001,483,251,3483,653,9934,Baja,83,2023-05-31,180,175,872,7821,10806,2985
2975,1645,1240,587,5473,1574,16905,Media-Baja,84,2023-05-31,287,643,5228,14424,22133,7709
1420,894,521,233,4234,842,9052,Baja,85,2023-05-31,177,182,798,8503,9850,1347
1573,685,390,222,4493,817,9508,Baja,86,2023-05-31,185,176,779,8541,10287,1746
3546,1737,1151,589,5340,1593,15702,Media-Baja,87,2023-05-31,289,664,4886,14909,20588,5679
2752,2082,1174,521,6260,1485,16849,Media-Baja,88,2023-05-31,264,639,4371,15177,21220,6043
1346,1043,376,241,3859,881,9751,Baja,89,2023-05-31,207,199,927,8152,10678,2526
1396,967,383,272,4004,676,8109,Baja,90,2023-05-31,177,218,857,8093,8966,873
3089,1461,1289,593,5521,1198,17090,Media-Baja,91,2023-05-31,306,663,4665,14120,21755,7635
4150,3451,2781,1407,6634,3089,36538,Media-Alta,92,2023-05-31,550,831,7438,22893,43976,21083
3029,1994,1215,675,6639,1470,17538,Media-Baja,93,2023-05-31,272,533,5788,15827,23326,7499
2895,1812,1372,640,5360,1571,16219,Media-Baja,94,2023-05-31,314,566,5205,14530,21424,6894
3856,1722,1193,651,5517,1773,20809,Media-Baja,95,2023-05-31,332,595,4308,15639,25117,9478
1648,928,433,271,4676,799,9711,Baja,96,2023-05-31,210,193,819,9158,10530,1372
3109,1817,1357,512,4430,1461,16953,Media-Baja,97,2023-05-31,250,572,5253,13508,22206,8698
1383,847,411,210,3700,670,10244,Baja,98,2023-05-31,173,186,1050,7580,11294,3714
3187,1692,1150,592,5672,1491,17774,Media-Baja,99,2023-05-31,265,635,5076,14684,22850,8166
4483,3214,2176,1209,6865,2848,28868,Media-Alta,0,2023-06-30,605,1018,6567,22418,35435,13017
1340,967,464,203,4190,682,8389,Baja,1,2023-06-30,176,195,971,8217,9360,1143
3144,1556,995,625,5690,1392,16474,Media-Baja,2,2023-06-30,330,575,5054,14307,21528,7221
4802,3002,2567,1215,5401,3412,37489,Media-Alta,3,2023-06-30,611,882,8435,21892,45924,24032
1541,947,359,201,3714,686,11385,Baja,4,2023-06-30,180,169,861,7797,12246,4449
3121,1938,1226,570,4867,1459,17378,Media-Baja,5,2023-06-30,308,601,5747,14090,23125,9035
2804,1750,1079,524,5620,1892,18170,Media-Baja,6,2023-06-30,253,577,5259,14499,23429,8930
5197,4521,3387,2558,9859,5255,97334,Alta,7,2023-06-30,6048,5909,14500,42734,111834,69100
4910,2979,2933,1267,8687,3085,37345,Media-Alta,8,2023-06-30,694,928,8570,25483,45915,20432
5194,3744,3720,2323,9526,5124,89084,Alta,9,2023-06-30,6409,6433,17006,42473,106090,63617
3024,1678,1386,677,5992,1527,19740,Media-Baja,10,2023-06-30,292,623,4877,15199,24617,9418
2640,1811,1372,561,5814,1555,16812,Media-Baja,11,2023-06-30,338,717,4432,14808,21244,6436
3327,1819,1226,698,6093,1593,18256,Media-Baja,12,2023-06-30,275,542,5244,15573,23500,7927
4510,3929,2553,1184,6260,3065,39441,Media-Alta,13,2023-06-30,610,759,9320,22870,48761,25891
3139,1845,1097,550,6196,1515,15707,Media-Baja,14,2023-06-30,292,623,4573,15257,20280,5023
1579,681,455,229,4648,729,8536,Baja,15,2023-06-30,219,185,727,8725,9263,538
2753,1752,1288,677,6208,1563,16548,Media-Baja,16,2023-06-30,254,626,5192,15121,21740,6619
3138,1858,1089,625,5168,1324,17896,Media-Baja,17,2023-06-30,318,572,4619,14092,22515,8423
3379,1638,1030,537,4869,1280,20133,Media-Baja,18,2023-06-30,335,579,5253,13647,25386,11739
3267,1686,1135,591,6255,1514,17828,Media-Baja,19,2023-06-30,294,647,5228,15389,23056,7667
2924,1614,986,608,5350,1486,20302,Media-Baja,20,2023-06-30,338,572,5399,13878,25701,11823
4295,3252,2347,1364,6506,3388,33499,Media-Alta,21,2023-06-30,622,934,7183,22708,40682,17974
5318,4280,2392,1116,5572,3767,40793,Media-Alta,22,2023-06-30,537,1002,8195,23984,48988,25004
2674,1619,1229,589,5382,1881,19674,Media-Baja,23,2023-06-30,319,563,5819,14256,25493,11237
1619,955,430,195,3674,634,9841,Baja,24,2023-06-30,206,192,832,7905,10673,2768
6557,5321,4433,1878,10719,5617,72411,Alta,25,2023-06-30,6866,4962,17188,46353,89599,43246
4816,3590,2786,1384,6748,3127,32629,Media-Alta,26,2023-06-30,671,911,6940,24033,39569,15536
1632,932,418,259,3620,744,9347,Baja,27,2023-06-30,179,181,706,7965,10053,2088
4673,3297,2305,1147,6690,3201,44571,Media-Alta,28,2023-06-30,577,810,6620,22700,51191,28491
1375,818,412,260,4297,794,10196,Baja,29,2023-06-30,192,176,819,8324,11015,2691
2863,1686,1239,512,4674,1747,18662,Media-Baja,30,2023-06-30,343,607,5345,13671,24007,10336
3924,4183,2282,1322,7220,2941,33308,Media-Alta,31,2023-06-30,549,907,7451,23328,40759,17431
1718,960,426,272,4536,613,9280,Baja,32,2023-06-30,187,165,882,8877,10162,1285
6425,5225,3534,2024,10345,5082,71620,Alta,33,2023-06-30,5402,6117,15429,44154,87049,42895
2571,1844,1174,583,3963,1172,19342,Media-Baja,34,2023-06-30,307,646,3827,12260,23169,10909
2955,1978,1244,534,5338,1168,17681,Media-Baja,35,2023-06-30,301,566,5246,14084,22927,8843
2941,1791,968,645,4268,1458,17959,Media-Baja,36,2023-06-30,316,592,4709,12979,22668,9689
2930,1513,1247,688,5215,1508,18258,Media-Baja,37,2023-06-30,310,659,4874,14070,23132,9062
2544,1931,1074,507,5953,1566,17673,Media-Baja,38,2023-06-30,319,603,4886,14497,22559,8062
7364,5052,3483,2300,9560,4486,88948,Alta,39,2023-06-30,5836,5053,15102,43134,104050,60916
5546,3715,4192,1997,10640,4975,83884,Alta,40,2023-06-30,5432,5939,18003,42436,101887,59451
6140,4767,3465,2257,12219,4774,80468,Alta,41,2023-06-30,5619,5009,13861,44250,94329,50079
4631,2996,2378,1393,6170,2737,35663,Media-Alta,42,2023-06-30,621,891,8791,21817,44454,22637
6510,4774,3659,2222,8872,4447,94901,Alta,43,2023-06-30,7396,5693,16649,43573,111550,67977
7468,5099,4636,1913,10089,4994,78206,Alta,44,2023-06-30,5113,5695,14801,45007,93007,48000
4053,3213,2116,1053,6930,3037,35307,Media-Alta,45,2023-06-30,562,1026,6760,21990,42067,20077
4213,3303,2184,1497,6266,2925,33114,Media-Alta,46,2023-06-30,620,841,7545,21849,40659,18810
2793,1758,1215,556,5006,1663,17726,Media-Baja,47,2023-06-30,360,593,5139,13944,22865,8921
2699,1672,1282,617,4707,1311,17175,Media-Baja,48,2023-06-30,290,596,4323,13174,21498,8324
3180,2038,941,480,6115,1773,18621,Media-Baja,49,2023-06-30,365,599,5584,15491,24205,8714
3138,2097,1039,567,5905,1484,19791,Media-Baja,50,2023-06-30,330,774,5203,15334,24994,9660
1550,877,363,229,3972,681,10596,Baja,51,2023-06-30,193,157,887,8022,11483,3461
4404,3571,2219,1012,5723,2979,39592,Media-Alta,52,2023-06-30,693,891,8453,21492,48045,26553
1537,998,399,209,4030,759,9845,Baja,53,2023-06-30,165,175,841,8272,10686,2414
4896,3184,2586,1291,8108,2562,35904,Media-Alta,54,2023-06-30,607,859,8360,24093,44264,20171
3044,1821,1117,631,4624,1544,19680,Media-Baja,55,2023-06-30,280,605,5249,13666,24929,11263
1555,795,405,276,4177,717,10002,Baja,56,2023-06-30,181,200,815,8306,10817,2511
3007,2019,1227,509,4887,1178,17376,Media-Baja,57,2023-06-30,270,691,4995,13788,22371,8583
2774,2202,1122,579,5426,1495,19395,Media-Baja,58,2023-06-30,301,544,4471,14443,23866,9423
3719,2970,2446,1111,5809,2985,37559,Media-Alta,59,2023-06-30,536,753,7980,20329,45539,25210
2930,1739,1232,802,5415,1416,17555,Media-Baja,60,2023-06-30,290,570,4571,14394,22126,7732
2412,1821,1446,716,5272,1353,16786,Media-Baja,61,2023-06-30,272,587,5410,13879,22196,8317
3984,3540,2297,1288,6779,2768,31104,Media-Alta,62,2023-06-30,593,922,7150,22171,38254,16083
2982,1859,1250,610,6265,1560,16978,Media-Baja,63,2023-06-30,307,596,4885,15429,21863,6434
4338,3141,2045,1077,6116,3227,28781,Media-Alta,64,2023-06-30,610,1021,8356,21575,37137,15562
5499,3358,2818,1137,7987,2369,36860,Media-Alta,65,2023-06-30,643,925,7826,24736,44686,19950
4016,3558,2347,1190,5783,3320,37181,Media-Alta,66,2023-06-30,645,977,7612,21836,44793,22957
5087,3755,2651,1245,7351,2723,33611,Media-Alta,67,2023-06-30,677,842,9524,24331,43135,18804
1452,855,397,242,4719,760,10857,Baja,69,2023-06-30,168,173,885,8766,11742,2976
2965,2059,1335,596,5029,1685,15767,Media-Baja,70,2023-06-30,314,603,5104,14586,20871,6285
6128,4643,3785,2360,9121,4008,75781,Alta,71,2023-06-30,6611,4447,14893,41103,90674,49571
1505,1036,399,247,4012,760,10174,Baja,72,2023-06-30,161,193,712,8313,10886,2573
1637,881,506,250,4458,724,10015,Baja,73,2023-06-30,146,179,897,8781,10912,2131
2856,1632,1287,611,5322,1031,17108,Media-Baja,74,2023-06-30,381,657,4887,13777,21995,8218
4783,2618,2544,973,6946,3273,33695,Media-Alta,75,2023-06-30,591,932,8864,22660,42559,19899
3199,1907,1187,548,4938,1283,17167,Media-Baja,76,2023-06-30,286,664,4748,14012,21915,7903
3071,1785,1180,611,6005,1690,16648,Media-Baja,77,2023-06-30,269,619,5397,15230,22045,6815
4017,3668,2612,1093,6974,2827,33842,Media-Alta,79,2023-06-30,564,991,8505,22746,42347,19601
4641,3036,2049,1393,5766,2794,39001,Media-Alta,80,2023-06-30,685,896,6343,21260,45344,24084
2988,1847,1151,526,5393,1545,19631,Media-Baja,81,2023-06-30,283,530,4365,14263,23996,9733
1306,1038,426,265,4183,617,10638,Baja,82,2023-06-30,177,167,885,8179,11523,3344
1595,1001,483,251,3483,653,9934,Baja,83,2023-06-30,168,171,909,7805,10843,3038
2975,1645,1240,587,5473,1574,16905,Media-Baja,84,2023-06-30,216,625,5036,14335,21941,7606
1420,894,521,233,4234,842,9052,Baja,85,2023-06-30,168,205,811,8517,9863,1346
1573,685,390,222,4493,817,9508,Baja,86,2023-06-30,165,188,880,8533,10388,1855
3546,1737,1151,589,5340,1593,15702,Media-Baja,87,2023-06-30,289,584,4263,14829,19965,5136
2752,2082,1174,521,6260,1485,16849,Media-Baja,88,2023-06-30,270,615,4015,15159,20864,5705
1346,1043,376,241,3859,881,9751,Baja,89,2023-06-30,192,179,862,8117,10613,2496
1396,967,383,272,4004,676,8109,Baja,90,2023-06-30,185,183,772,8066,8881,815
3089,1461,1289,593,5521,1198,17090,Media-Baja,91,2023-06-30,305,480,4967,13936,22057,8121
4150,3451,2781,1407,6634,3089,36538,Media-Alta,92,2023-06-30,524,956,7209,22992,43747,20755
3029,1994,1215,675,6639,1470,17538,Media-Baja,93,2023-06-30,337,610,5017,15969,22555,6586
2895,1812,1372,640,5360,1571,16219,Media-Baja,94,2023-06-30,287,550,4637,14487,20856,6369
3856,1722,1193,651,5517,1773,20809,Media-Baja,95,2023-06-30,326,557,4623,15595,25432,9837
1648,928,433,271,4676,799,9711,Baja,96,2023-06-30,192,188,645,9135,10356,1221
3109,1817,1357,512,4430,1461,16953,Media-Baja,97,2023-06-30,257,640,5240,13583,22193,8610
1383,847,411,210,3700,670,10244,Baja,98,2023-06-30,156,209,911,7586,11155,3569
3187,1692,1150,592,5672,1491,17774,Media-Baja,99,2023-06-30,340,604,4750,14728,22524,7796
4483,3214,2176,1209,6865,2848,28868,Media-Alta,0,2023-07-31,669,967,5312,22431,34180,11749
1340,967,464,203,4190,682,8389,Baja,1,2023-07-31,158,187,905,8191,9294,1103
3144,1556,995,625,5690,1392,16474,Media-Baja,2,2023-07-31,278,623,4564,14303,21038,6735
4802,3002,2567,1215,5401,3412,37489,Media-Alta,3,2023-07-31,543,812,7558,21754,45047,23293
1541,947,359,201,3714,686,11385,Baja,4,2023-07-31,158,161,965,7767,12350,4583
3121,1938,1226,570,4867,1459,17378,Media-Baja,5,2023-07-31,272,649,4335,14102,21713,7611
2804,1750,1079,524,5620,1892,18170,Media-Baja,6,2023-07-31,284,610,4457,14563,22627,8064
5197,4521,3387,2558,9859,5255,97334,Alta,7,2023-07-31,5441,5255,16644,41473,113978,72505
4910,2979,2933,1267,8687,3085,37345,Media-Alta,8,2023-07-31,591,1018,8049,25470,45394,19924
5194,3744,3720,2323,9526,5124,89084,Alta,9,2023-07-31,6134,5407,15693,41172,104777,63605
3024,1678,1386,677,5992,1527,19740,Media-Baja,10,2023-07-31,293,461,4590,15038,24330,9292
2640,1811,1372,561,5814,1555,16812,Media-Baja,11,2023-07-31,301,545,4264,14599,21076,6477
3327,1819,1226,698,6093,1593,18256,Media-Baja,12,2023-07-31,263,506,5331,15525,23587,8062
4510,3929,2553,1184,6260,3065,39441,Media-Alta,13,2023-07-31,574,885,6138,22960,45579,22619
3139,1845,1097,550,6196,1515,15707,Media-Baja,14,2023-07-31,288,568,5590,15198,21297,6099
1579,681,455,229,4648,729,8536,Baja,15,2023-07-31,197,182,949,8700,9485,785
2753,1752,1288,677,6208,1563,16548,Media-Baja,16,2023-07-31,324,503,5422,15068,21970,6902
3138,1858,1089,625,5168,1324,17896,Media-Baja,17,2023-07-31,336,484,5167,14022,23063,9041
3379,1638,1030,537,4869,1280,20133,Media-Baja,18,2023-07-31,326,634,5967,13693,26100,12407
3267,1686,1135,591,6255,1514,17828,Media-Baja,19,2023-07-31,262,722,4842,15432,22670,7238
2924,1614,986,608,5350,1486,20302,Media-Baja,20,2023-07-31,332,508,5535,13808,25837,12029
4295,3252,2347,1364,6506,3388,33499,Media-Alta,21,2023-07-31,545,905,8231,22602,41730,19128
5318,4280,2392,1116,5572,3767,40793,Media-Alta,22,2023-07-31,619,954,8163,24018,48956,24938
2674,1619,1229,589,5382,1881,19674,Media-Baja,23,2023-07-31,276,465,4555,14115,24229,10114
1619,955,430,195,3674,634,9841,Baja,24,2023-07-31,186,187,830,7880,10671,2791
6557,5321,4433,1878,10719,5617,72411,Alta,25,2023-07-31,5361,5868,19214,45754,91625,45871
4816,3590,2786,1384,6748,3127,32629,Media-Alta,26,2023-07-31,599,861,7599,23911,40228,16317
1632,932,418,259,3620,744,9347,Baja,27,2023-07-31,187,153,995,7945,10342,2397
4673,3297,2305,1147,6690,3201,44571,Media-Alta,28,2023-07-31,673,1104,7389,23090,51960,28870
1375,818,412,260,4297,794,10196,Baja,29,2023-07-31,149,125,795,8230,10991,2761
2863,1686,1239,512,4674,1747,18662,Media-Baja,30,2023-07-31,307,583,5286,13611,23948,10337
3924,4183,2282,1322,7220,2941,33308,Media-Alta,31,2023-07-31,613,929,8670,23414,41978,18564
1718,960,426,272,4536,613,9280,Baja,32,2023-07-31,169,199,907,8893,10187,1294
6425,5225,3534,2024,10345,5082,71620,Alta,33,2023-07-31,6722,6142,19981,45499,91601,46102
2571,1844,1174,583,3963,1172,19342,Media-Baja,34,2023-07-31,266,592,5173,12165,24515,12350
2955,1978,1244,534,5338,1168,17681,Media-Baja,35,2023-07-31,312,518,4020,14047,21701,7654
2941,1791,968,645,4268,1458,17959,Media-Baja,36,2023-07-31,328,671,4963,13070,22922,9852
2930,1513,1247,688,5215,1508,18258,Media-Baja,37,2023-07-31,332,724,5598,14157,23856,9699
2544,1931,1074,507,5953,1566,17673,Media-Baja,38,2023-07-31,317,589,5919,14481,23592,9111
7364,5052,3483,2300,9560,4486,88948,Alta,39,2023-07-31,5765,5438,17329,43448,106277,62829
5546,3715,4192,1997,10640,4975,83884,Alta,40,2023-07-31,6762,5165,16187,42992,100071,57079
6140,4767,3465,2257,12219,4774,80468,Alta,41,2023-07-31,5511,5852,18591,44985,99059,54074
4631,2996,2378,1393,6170,2737,35663,Media-Alta,42,2023-07-31,644,772,7384,21721,43047,21326
6510,4774,3659,2222,8872,4447,94901,Alta,43,2023-07-31,6491,5279,16255,42254,111156,68902
7468,5099,4636,1913,10089,4994,78206,Alta,44,2023-07-31,6449,5119,18291,45767,96497,50730
4053,3213,2116,1053,6930,3037,35307,Media-Alta,45,2023-07-31,703,964,7108,22069,42415,20346
4213,3303,2184,1497,6266,2925,33114,Media-Alta,46,2023-07-31,616,917,8069,21921,41183,19262
2793,1758,1215,556,5006,1663,17726,Media-Baja,47,2023-07-31,284,537,5104,13812,22830,9018
2699,1672,1282,617,4707,1311,17175,Media-Baja,48,2023-07-31,268,572,5190,13128,22365,9237
3180,2038,941,480,6115,1773,18621,Media-Baja,49,2023-07-31,292,569,4886,15388,23507,8119
3138,2097,1039,567,5905,1484,19791,Media-Baja,50,2023-07-31,272,599,5347,15101,25138,10037
1550,877,363,229,3972,681,10596,Baja,51,2023-07-31,194,140,613,8006,11209,3203
4404,3571,2219,1012,5723,2979,39592,Media-Alta,52,2023-07-31,613,907,8079,21428,47671,26243
1537,998,399,209,4030,759,9845,Baja,53,2023-07-31,175,168,797,8275,10642,2367
4896,3184,2586,1291,8108,2562,35904,Media-Alta,54,2023-07-31,596,824,8242,24047,44146,20099
3044,1821,1117,631,4624,1544,19680,Media-Baja,55,2023-07-31,352,492,5007,13625,24687,11062
1555,795,405,276,4177,717,10002,Baja,56,2023-07-31,162,179,662,8266,10664,2398
3007,2019,1227,509,4887,1178,17376,Media-Baja,57,2023-07-31,307,583,5424,13717,22800,9083
2774,2202,1122,579,5426,1495,19395,Media-Baja,58,2023-07-31,275,668,4627,14541,24022,9481
3719,2970,2446,1111,5809,2985,37559,Media-Alta,59,2023-07-31,538,956,8449,20534,46008,25474
2930,1739,1232,802,5415,1416,17555,Media-Baja,60,2023-07-31,276,497,4436,14307,21991,7684
2412,1821,1446,716,5272,1353,16786,Media-Baja,61,2023-07-31,307,697,4966,14024,21752,7728
3984,3540,2297,1288,6779,2768,31104,Media-Alta,62,2023-07-31,658,742,8217,22056,39321,17265
2982,1859,1250,610,6265,1560,16978,Media-Baja,63,2023-07-31,308,601,5130,15435,22108,6673
4338,3141,2045,1077,6116,3227,28781,Media-Alta,64,2023-07-31,585,979,7620,21508,36401,14893
5499,3358,2818,1137,7987,2369,36860,Media-Alta,65,2023-07-31,658,853,8441,24679,45301,20622
4016,3558,2347,1190,5783,3320,37181,Media-Alta,66,2023-07-31,551,861,7079,21626,44260,22634
5087,3755,2651,1245,7351,2723,33611,Media-Alta,67,2023-07-31,621,1025,7704,24458,41315,16857
1452,855,397,242,4719,760,10857,Baja,69,2023-07-31,180,155,723,8760,11580,2820
2965,2059,1335,596,5029,1685,15767,Media-Baja,70,2023-07-31,292,572,4856,14533,20623,6090
6128,4643,3785,2360,9121,4008,75781,Alta,71,2023-07-31,5443,4791,15938,40279,91719,51440
1505,1036,399,247,4012,760,10174,Baja,72,2023-07-31,212,191,735,8362,10909,2547
1637,881,506,250,4458,724,10015,Baja,73,2023-07-31,159,185,690,8800,10705,1905
2856,1632,1287,611,5322,1031,17108,Media-Baja,74,2023-07-31,325,708,4698,13772,21806,8034
4783,2618,2544,973,6946,3273,33695,Media-Alta,75,2023-07-31,551,840,9744,22528,43439,20911
3199,1907,1187,548,4938,1283,17167,Media-Baja,76,2023-07-31,298,543,4244,13903,21411,7508
3071,1785,1180,611,6005,1690,16648,Media-Baja,77,2023-07-31,319,627,5185,15288,21833,6545
4017,3668,2612,1093,6974,2827,33842,Media-Alta,79,2023-07-31,621,1179,7940,22991,41782,18791
4641,3036,2049,1393,5766,2794,39001,Media-Alta,80,2023-07-31,605,989,8415,21273,47416,26143
2988,1847,1151,526,5393,1545,19631,Media-Baja,81,2023-07-31,295,619,5048,14364,24679,10315
1306,1038,426,265,4183,617,10638,Baja,82,2023-07-31,169,198,849,8202,11487,3285
1595,1001,483,251,3483,653,9934,Baja,83,2023-07-31,195,179,832,7840,10766,2926
2975,1645,1240,587,5473,1574,16905,Media-Baja,84,2023-07-31,233,543,4679,14270,21584,7314
1420,894,521,233,4234,842,9052,Baja,85,2023-07-31,161,177,932,8482,9984,1502
1573,685,390,222,4493,817,9508,Baja,86,2023-07-31,157,177,827,8514,10335,1821
3546,1737,1151,589,5340,1593,15702,Media-Baja,87,2023-07-31,271,550,4486,14777,20188,5411
2752,2082,1174,521,6260,1485,16849,Media-Baja,88,2023-07-31,258,593,5248,15125,22097,6972
1346,1043,376,241,3859,881,9751,Baja,89,2023-07-31,175,198,855,8119,10606,2487
1396,967,383,272,4004,676,8109,Baja,90,2023-07-31,203,153,855,8054,8964,910
3089,1461,1289,593,5521,1198,17090,Media-Baja,91,2023-07-31,323,635,4659,14109,21749,7640
4150,3451,2781,1407,6634,3089,36538,Media-Alta,92,2023-07-31,539,903,6273,22954,42811,19857
3029,1994,1215,675,6639,1470,17538,Media-Baja,93,2023-07-31,278,696,4967,15996,22505,6509
2895,1812,1372,640,5360,1571,16219,Media-Baja,94,2023-07-31,282,662,5315,14594,21534,6940
3856,1722,1193,651,5517,1773,20809,Media-Baja,95,2023-07-31,256,711,4984,15679,25793,10114
1648,928,433,271,4676,799,9711,Baja,96,2023-07-31,175,183,914,9113,10625,1512
3109,1817,1357,512,4430,1461,16953,Media-Baja,97,2023-07-31,352,561,4849,13599,21802,8203
1383,847,411,210,3700,670,10244,Baja,98,2023-07-31,192,168,881,7581,11125,3544
3187,1692,1150,592,5672,1491,17774,Media-Baja,99,2023-07-31,280,577,5415,14641,23189,8548
4483,3214,2176,1209,6865,2848,28868,Media-Alta,0,2023-08-31,682,962,7860,22439,36728,14289
1340,967,464,203,4190,682,8389,Baja,1,2023-08-31,195,171,839,8212,9228,1016
3144,1556,995,625,5690,1392,16474,Media-Baja,2,2023-08-31,325,607,4369,14334,20843,6509
4802,3002,2567,1215,5401,3412,37489,Media-Alta,3,2023-08-31,625,905,7874,21929,45363,23434
1541,947,359,201,3714,686,11385,Baja,4,2023-08-31,207,167,767,7822,12152,4330
3121,1938,1226,570,4867,1459,17378,Media-Baja,5,2023-08-31,295,656,4570,14132,21948,7816
2804,1750,1079,524,5620,1892,18170,Media-Baja,6,2023-08-31,257,585,5548,14511,23718,9207
5197,4521,3387,2558,9859,5255,97334,Alta,7,2023-08-31,4743,5758,18211,41278,115545,74267
4910,2979,2933,1267,8687,3085,37345,Media-Alta,8,2023-08-31,590,833,6338,25284,43683,18399
5194,3744,3720,2323,9526,5124,89084,Alta,9,2023-08-31,6657,5352,16177,41640,105261,63621
3024,1678,1386,677,5992,1527,19740,Media-Baja,10,2023-08-31,322,635,5229,15241,24969,9728
2640,1811,1372,561,5814,1555,16812,Media-Baja,11,2023-08-31,305,632,5280,14690,22092,7402
3327,1819,1226,698,6093,1593,18256,Media-Baja,12,2023-08-31,278,668,4870,15702,23126,7424
4510,3929,2553,1184,6260,3065,39441,Media-Alta,13,2023-08-31,601,913,9268,23015,48709,25694
3139,1845,1097,550,6196,1515,15707,Media-Baja,14,2023-08-31,282,643,4680,15267,20387,5120
1579,681,455,229,4648,729,8536,Baja,15,2023-08-31,186,197,892,8704,9428,724
2753,1752,1288,677,6208,1563,16548,Media-Baja,16,2023-08-31,292,665,4875,15198,21423,6225
3138,1858,1089,625,5168,1324,17896,Media-Baja,17,2023-08-31,292,683,4608,14177,22504,8327
3379,1638,1030,537,4869,1280,20133,Media-Baja,18,2023-08-31,240,620,5555,13593,25688,12095
3267,1686,1135,591,6255,1514,17828,Media-Baja,19,2023-08-31,277,626,5926,15351,23754,8403
2924,1614,986,608,5350,1486,20302,Media-Baja,20,2023-08-31,311,682,5755,13961,26057,12096
4295,3252,2347,1364,6506,3388,33499,Media-Alta,21,2023-08-31,677,706,8326,22535,41825,19290
5318,4280,2392,1116,5572,3767,40793,Media-Alta,22,2023-08-31,656,774,9120,23875,49913,26038
2674,1619,1229,589,5382,1881,19674,Media-Baja,23,2023-08-31,310,581,4720,14265,24394,10129
1619,955,430,195,3674,634,9841,Baja,24,2023-08-31,187,181,992,7875,10833,2958
6557,5321,4433,1878,10719,5617,72411,Alta,25,2023-08-31,6315,5880,16230,46720,88641,41921
4816,3590,2786,1384,6748,3127,32629,Media-Alta,26,2023-08-31,583,906,7122,23940,39751,15811
1632,932,418,259,3620,744,9347,Baja,27,2023-08-31,171,176,867,7952,10214,2262
4673,3297,2305,1147,6690,3201,44571,Media-Alta,28,2023-08-31,584,877,6414,22774,50985,28211
1375,818,412,260,4297,794,10196,Baja,29,2023-08-31,163,182,950,8301,11146,2845
2863,1686,1239,512,4674,1747,18662,Media-Baja,30,2023-08-31,304,614,5388,13639,24050,10411
3924,4183,2282,1322,7220,2941,33308,Media-Alta,31,2023-08-31,598,758,6833,23228,40141,16913
1718,960,426,272,4536,613,9280,Baja,32,2023-08-31,182,207,704,8914,9984,1070
6425,5225,3534,2024,10345,5082,71620,Alta,33,2023-08-31,6155,5283,21075,44073,92695,48622
2571,1844,1174,583,3963,1172,19342,Media-Baja,34,2023-08-31,363,643,4921,12313,24263,11950
2955,1978,1244,534,5338,1168,17681,Media-Baja,35,2023-08-31,283,663,4505,14163,22186,8023
2941,1791,968,645,4268,1458,17959,Media-Baja,36,2023-08-31,269,677,5291,13017,23250,10233
2930,1513,1247,688,5215,1508,18258,Media-Baja,37,2023-08-31,306,556,4843,13963,23101,9138
2544,1931,1074,507,5953,1566,17673,Media-Baja,38,2023-08-31,289,601,5373,14465,23046,8581
7364,5052,3483,2300,9560,4486,88948,Alta,39,2023-08-31,7862,5843,17453,45950,106401,60451
5546,3715,4192,1997,10640,4975,83884,Alta,40,2023-08-31,5776,5018,18042,41859,101926,60067
6140,4767,3465,2257,12219,4774,80468,Alta,41,2023-08-31,5792,5789,15058,45203,95526,50323
4631,2996,2378,1393,6170,2737,35663,Media-Alta,42,2023-08-31,573,908,6365,21786,42028,20242
6510,4774,3659,2222,8872,4447,94901,Alta,43,2023-08-31,6487,5789,17968,42760,112869,70109
7468,5099,4636,1913,10089,4994,78206,Alta,44,2023-08-31,6738,5118,17981,46055,96187,50132
4053,3213,2116,1053,6930,3037,35307,Media-Alta,45,2023-08-31,682,1138,7607,22222,42914,20692
4213,3303,2184,1497,6266,2925,33114,Media-Alta,46,2023-08-31,603,851,8726,21842,41840,19998
2793,1758,1215,556,5006,1663,17726,Media-Baja,47,2023-08-31,302,633,5766,13926,23492,9566
2699,1672,1282,617,4707,1311,17175,Media-Baja,48,2023-08-31,306,549,4610,13143,21785,8642
3180,2038,941,480,6115,1773,18621,Media-Baja,49,2023-08-31,308,620,4755,15455,23376,7921
3138,2097,1039,567,5905,1484,19791,Media-Baja,50,2023-08-31,328,653,5269,15211,25060,9849
1550,877,363,229,3972,681,10596,Baja,51,2023-08-31,182,179,958,8033,11554,3521
4404,3571,2219,1012,5723,2979,39592,Media-Alta,52,2023-08-31,579,889,7075,21376,46667,25291
1537,998,399,209,4030,759,9845,Baja,53,2023-08-31,175,216,752,8323,10597,2274
4896,3184,2586,1291,8108,2562,35904,Media-Alta,54,2023-08-31,590,930,7335,24147,43239,19092
3044,1821,1117,631,4624,1544,19680,Media-Baja,55,2023-08-31,294,580,4545,13655,24225,10570
1555,795,405,276,4177,717,10002,Baja,56,2023-08-31,168,163,886,8256,10888,2632
3007,2019,1227,509,4887,1178,17376,Media-Baja,57,2023-08-31,262,687,5327,13776,22703,8927
2774,2202,1122,579,5426,1495,19395,Media-Baja,58,2023-08-31,322,436,4781,14356,24176,9820
3719,2970,2446,1111,5809,2985,37559,Media-Alta,59,2023-08-31,441,813,8754,20294,46313,26019
2930,1739,1232,802,5415,1416,17555,Media-Baja,60,2023-08-31,278,661,5709,14473,23264,8791
2412,1821,1446,716,5272,1353,16786,Media-Baja,61,2023-08-31,282,460,5024,13762,21810,8048
3984,3540,2297,1288,6779,2768,31104,Media-Alta,62,2023-08-31,615,835,8237,22106,39341,17235
2982,1859,1250,610,6265,1560,16978,Media-Baja,63,2023-08-31,341,604,5714,15471,22692,7221
4338,3141,2045,1077,6116,3227,28781,Media-Alta,64,2023-08-31,708,772,7648,21424,36429,15005
5499,3358,2818,1137,7987,2369,36860,Media-Alta,65,2023-08-31,605,922,8513,24695,45373,20678
4016,3558,2347,1190,5783,3320,37181,Media-Alta,66,2023-08-31,650,867,7500,21731,44681,22950
5087,3755,2651,1245,7351,2723,33611,Media-Alta,67,2023-08-31,623,992,5897,24427,39508,15081
1452,855,397,242,4719,760,10857,Baja,69,2023-08-31,173,168,798,8766,11655,2889
2965,2059,1335,596,5029,1685,15767,Media-Baja,70,2023-08-31,329,639,5174,14637,20941,6304
6128,4643,3785,2360,9121,4008,75781,Alta,71,2023-08-31,5219,5837,18302,41101,94083,52982
1505,1036,399,247,4012,760,10174,Baja,72,2023-08-31,189,193,831,8341,11005,2664
1637,881,506,250,4458,724,10015,Baja,73,2023-08-31,158,171,670,8785,10685,1900
2856,1632,1287,611,5322,1031,17108,Media-Baja,74,2023-08-31,290,552,5831,13581,22939,9358
4783,2618,2544,973,6946,3273,33695,Media-Alta,75,2023-08-31,613,1015,8265,22765,41960,19195
3199,1907,1187,548,4938,1283,17167,Media-Baja,76,2023-08-31,322,639,4649,14023,21816,7793
3071,1785,1180,611,6005,1690,16648,Media-Baja,77,2023-08-31,322,443,5189,15107,21837,6730
4017,3668,2612,1093,6974,2827,33842,Media-Alta,79,2023-08-31,589,919,8140,22699,41982,19283
4641,3036,2049,1393,5766,2794,39001,Media-Alta,80,2023-08-31,537,742,7476,20958,46477,25519
2988,1847,1151,526,5393,1545,19631,Media-Baja,81,2023-08-31,308,738,5072,14496,24703,10207
1306,1038,426,265,4183,617,10638,Baja,82,2023-08-31,169,169,872,8173,11510,3337
1595,1001,483,251,3483,653,9934,Baja,83,2023-08-31,188,165,848,7819,10782,2963
2975,1645,1240,587,5473,1574,16905,Media-Baja,84,2023-08-31,302,597,5337,14393,22242,7849
1420,894,521,233,4234,842,9052,Baja,85,2023-08-31,163,210,796,8517,9848,1331
1573,685,390,222,4493,817,9508,Baja,86,2023-08-31,192,159,845,8531,10353,1822
3546,1737,1151,589,5340,1593,15702,Media-Baja,87,2023-08-31,294,550,5129,14800,20831,6031
2752,2082,1174,521,6260,1485,16849,Media-Baja,88,2023-08-31,301,509,5082,15084,21931,6847
1346,1043,376,241,3859,881,9751,Baja,89,2023-08-31,164,167,766,8077,10517,2440
1396,967,383,272,4004,676,8109,Baja,90,2023-08-31,194,173,882,8065,8991,926
3089,1461,1289,593,5521,1198,17090,Media-Baja,91,2023-08-31,307,566,4912,14024,22002,7978
4150,3451,2781,1407,6634,3089,36538,Media-Alta,92,2023-08-31,601,736,7604,22849,44142,21293
3029,1994,1215,675,6639,1470,17538,Media-Baja,93,2023-08-31,312,671,5673,16005,23211,7206
2895,1812,1372,640,5360,1571,16219,Media-Baja,94,2023-08-31,288,598,5482,14536,21701,7165
3856,1722,1193,651,5517,1773,20809,Media-Baja,95,2023-08-31,324,746,5136,15782,25945,10163
1648,928,433,271,4676,799,9711,Baja,96,2023-08-31,200,176,883,9131,10594,1463
3109,1817,1357,512,4430,1461,16953,Media-Baja,97,2023-08-31,298,651,4414,13635,21367,7732
1383,847,411,210,3700,670,10244,Baja,98,2023-08-31,201,163,857,7585,11101,3516
3187,1692,1150,592,5672,1491,17774,Media-Baja,99,2023-08-31,326,482,4059,14592,21833,7241
4483,3214,2176,1209,6865,2848,28868,Media-Alta,0,2023-09-30,470,972,8525,22237,37393,15156
1340,967,464,203,4190,682,8389,Baja,1,2023-09-30,183,169,832,8198,9221,1023
3144,1556,995,625,5690,1392,16474,Media-Baja,2,2023-09-30,296,532,5171,14230,21645,7415
4802,3002,2567,1215,5401,3412,37489,Media-Alta,3,2023-09-30,599,900,7391,21898,44880,22982
1541,947,359,201,3714,686,11385,Baja,4,2023-09-30,173,188,866,7809,12251,4442
3121,1938,1226,570,4867,1459,17378,Media-Baja,5,2023-09-30,329,649,4505,14159,21883,7724
2804,1750,1079,524,5620,1892,18170,Media-Baja,6,2023-09-30,317,543,5516,14529,23686,9157
5197,4521,3387,2558,9859,5255,97334,Alta,7,2023-09-30,5875,4884,16737,41536,114071,72535
4910,2979,2933,1267,8687,3085,37345,Media-Alta,8,2023-09-30,497,1012,8080,25370,45425,20055
5194,3744,3720,2323,9526,5124,89084,Alta,9,2023-09-30,6415,6372,13505,42418,102589,60171
3024,1678,1386,677,5992,1527,19740,Media-Baja,10,2023-09-30,264,605,4126,15153,23866,8713
2640,1811,1372,561,5814,1555,16812,Media-Baja,11,2023-09-30,301,536,4865,14590,21677,7087
3327,1819,1226,698,6093,1593,18256,Media-Baja,12,2023-09-30,295,637,3976,15688,22232,6544
4510,3929,2553,1184,6260,3065,39441,Media-Alta,13,2023-09-30,631,855,9340,22987,48781,25794
3139,1845,1097,550,6196,1515,15707,Media-Baja,14,2023-09-30,343,486,5275,15171,20982,5811
1579,681,455,229,4648,729,8536,Baja,15,2023-09-30,191,162,796,8674,9332,658
2753,1752,1288,677,6208,1563,16548,Media-Baja,16,2023-09-30,260,549,5543,15050,22091,7041
3138,1858,1089,625,5168,1324,17896,Media-Baja,17,2023-09-30,292,676,5206,14170,23102,8932
3379,1638,1030,537,4869,1280,20133,Media-Baja,18,2023-09-30,239,613,5019,13585,25152,11567
3267,1686,1135,591,6255,1514,17828,Media-Baja,19,2023-09-30,353,589,5309,15390,23137,7747
2924,1614,986,608,5350,1486,20302,Media-Baja,20,2023-09-30,307,570,4108,13845,24410,10565
4295,3252,2347,1364,6506,3388,33499,Media-Alta,21,2023-09-30,587,714,8717,22453,42216,19763
5318,4280,2392,1116,5572,3767,40793,Media-Alta,22,2023-09-30,552,849,7313,23846,48106,24260
2674,1619,1229,589,5382,1881,19674,Media-Baja,23,2023-09-30,328,637,4764,14339,24438,10099
1619,955,430,195,3674,634,9841,Baja,24,2023-09-30,191,209,809,7907,10650,2743
6557,5321,4433,1878,10719,5617,72411,Alta,25,2023-09-30,5310,4571,18534,44406,90945,46539
4816,3590,2786,1384,6748,3127,32629,Media-Alta,26,2023-09-30,551,988,7360,23990,39989,15999
1632,932,418,259,3620,744,9347,Baja,27,2023-09-30,161,173,1008,7939,10355,2416
4673,3297,2305,1147,6690,3201,44571,Media-Alta,28,2023-09-30,627,973,8353,22913,52924,30011
1375,818,412,260,4297,794,10196,Baja,29,2023-09-30,174,193,793,8323,10989,2666
2863,1686,1239,512,4674,1747,18662,Media-Baja,30,2023-09-30,284,632,4107,13637,22769,9132
3924,4183,2282,1322,7220,2941,33308,Media-Alta,31,2023-09-30,566,1026,8760,23464,42068,18604
1718,960,426,272,4536,613,9280,Baja,32,2023-09-30,165,186,760,8876,10040,1164
6425,5225,3534,2024,10345,5082,71620,Alta,33,2023-09-30,5842,5307,16390,43784,88010,44226
2571,1844,1174,583,3963,1172,19342,Media-Baja,34,2023-09-30,282,533,4153,12122,23495,11373
2955,1978,1244,534,5338,1168,17681,Media-Baja,35,2023-09-30,307,597,3792,14121,21473,7352
2941,1791,968,645,4268,1458,17959,Media-Baja,36,2023-09-30,259,451,5335,12781,23294,10513
2930,1513,1247,688,5215,1508,18258,Media-Baja,37,2023-09-30,331,554,5305,13986,23563,9577
2544,1931,1074,507,5953,1566,17673,Media-Baja,38,2023-09-30,299,626,5089,14500,22762,8262
7364,5052,3483,2300,9560,4486,88948,Alta,39,2023-09-30,6362,5614,18398,44221,107346,63125
5546,3715,4192,1997,10640,4975,83884,Alta,40,2023-09-30,5556,5691,18349,42312,102233,59921
6140,4767,3465,2257,12219,4774,80468,Alta,41,2023-09-30,5749,5780,15376,45151,95844,50693
4631,2996,2378,1393,6170,2737,35663,Media-Alta,42,2023-09-30,564,836,8085,21705,43748,22043
6510,4774,3659,2222,8872,4447,94901,Alta,43,2023-09-30,4947,5403,16094,40834,110995,70161
7468,5099,4636,1913,10089,4994,78206,Alta,44,2023-09-30,6214,4999,17835,45412,96041,50629
4053,3213,2116,1053,6930,3037,35307,Media-Alta,45,2023-09-30,564,986,8203,21952,43510,21558
4213,3303,2184,1497,6266,2925,33114,Media-Alta,46,2023-09-30,659,935,7539,21982,40653,18671
2793,1758,1215,556,5006,1663,17726,Media-Baja,47,2023-09-30,319,685,5727,13995,23453,9458
2699,1672,1282,617,4707,1311,17175,Media-Baja,48,2023-09-30,319,595,4515,13202,21690,8488
3180,2038,941,480,6115,1773,18621,Media-Baja,49,2023-09-30,284,632,4545,15443,23166,7723
3138,2097,1039,567,5905,1484,19791,Media-Baja,50,2023-09-30,304,585,5503,15119,25294,10175
1550,877,363,229,3972,681,10596,Baja,51,2023-09-30,170,203,944,8045,11540,3495
4404,3571,2219,1012,5723,2979,39592,Media-Alta,52,2023-09-30,619,952,8229,21479,47821,26342
1537,998,399,209,4030,759,9845,Baja,53,2023-09-30,165,171,985,8268,10830,2562
4896,3184,2586,1291,8108,2562,35904,Media-Alta,54,2023-09-30,542,780,7472,23949,43376,19427
3044,1821,1117,631,4624,1544,19680,Media-Baja,55,2023-09-30,320,680,6194,13781,25874,12093
1555,795,405,276,4177,717,10002,Baja,56,2023-09-30,186,179,771,8290,10773,2483
3007,2019,1227,509,4887,1178,17376,Media-Baja,57,2023-09-30,269,722,4753,13818,22129,8311
2774,2202,1122,579,5426,1495,19395,Media-Baja,58,2023-09-30,322,617,4599,14537,23994,9457
3719,2970,2446,1111,5809,2985,37559,Media-Alta,59,2023-09-30,519,941,8088,20500,45647,25147
2930,1739,1232,802,5415,1416,17555,Media-Baja,60,2023-09-30,241,619,4048,14394,21603,7209
2412,1821,1446,716,5272,1353,16786,Media-Baja,61,2023-09-30,295,611,5302,13926,22088,8162
3984,3540,2297,1288,6779,2768,31104,Media-Alta,62,2023-09-30,538,929,8178,22123,39282,17159
2982,1859,1250,610,6265,1560,16978,Media-Baja,63,2023-09-30,322,647,4724,15495,21702,6207
4338,3141,2045,1077,6116,3227,28781,Media-Alta,64,2023-09-30,609,989,6951,21542,35732,14190
5499,3358,2818,1137,7987,2369,36860,Media-Alta,65,2023-09-30,579,976,8311,24723,45171,20448
4016,3558,2347,1190,5783,3320,37181,Media-Alta,66,2023-09-30,688,923,7480,21825,44661,22836
5087,3755,2651,1245,7351,2723,33611,Media-Alta,67,2023-09-30,674,871,8669,24357,42280,17923
1452,855,397,242,4719,760,10857,Baja,69,2023-09-30,212,179,796,8816,11653,2837
2965,2059,1335,596,5029,1685,15767,Media-Baja,70,2023-09-30,286,574,5473,14529,21240,6711
6128,4643,3785,2360,9121,4008,75781,Alta,71,2023-09-30,6702,5456,16403,42203,92184,49981
1505,1036,399,247,4012,760,10174,Baja,72,2023-09-30,159,185,956,8303,11130,2827
1637,881,506,250,4458,724,10015,Baja,73,2023-09-30,193,185,693,8834,10708,1874
2856,1632,1287,611,5322,1031,17108,Media-Baja,74,2023-09-30,326,554,4993,13619,22101,8482
4783,2618,2544,973,6946,3273,33695,Media-Alta,75,2023-09-30,595,848,8212,22580,41907,19327
3199,1907,1187,548,4938,1283,17167,Media-Baja,76,2023-09-30,281,668,4390,14011,21557,7546
3071,1785,1180,611,6005,1690,16648,Media-Baja,77,2023-09-30,312,621,4381,15275,21029,5754
4017,3668,2612,1093,6974,2827,33842,Media-Alta,79,2023-09-30,580,911,7670,22682,41512,18830
4641,3036,2049,1393,5766,2794,39001,Media-Alta,80,2023-09-30,633,899,7596,21211,46597,25386
2988,1847,1151,526,5393,1545,19631,Media-Baja,81,2023-09-30,348,662,4634,14460,24265,9805
1306,1038,426,265,4183,617,10638,Baja,82,2023-09-30,192,179,911,8206,11549,3343
1595,1001,483,251,3483,653,9934,Baja,83,2023-09-30,177,185,779,7828,10713,2885
2975,1645,1240,587,5473,1574,16905,Media-Baja,84,2023-09-30,298,599,4470,14391,21375,6984
1420,894,521,233,4234,842,9052,Baja,85,2023-09-30,207,189,756,8540,9808,1268
1573,685,390,222,4493,817,9508,Baja,86,2023-09-30,170,167,829,8517,10337,1820
3546,1737,1151,589,5340,1593,15702,Media-Baja,87,2023-09-30,253,466,4754,14675,20456,5781
2752,2082,1174,521,6260,1485,16849,Media-Baja,88,2023-09-30,310,570,5242,15154,22091,6937
1346,1043,376,241,3859,881,9751,Baja,89,2023-09-30,187,206,843,8139,10594,2455
1396,967,383,272,4004,676,8109,Baja,90,2023-09-30,162,195,774,8055,8883,828
3089,1461,1289,593,5521,1198,17090,Media-Baja,91,2023-09-30,247,599,4447,13997,21537,7540
4150,3451,2781,1407,6634,3089,36538,Media-Alta,92,2023-09-30,589,834,7507,22935,44045,21110
3029,1994,1215,675,6639,1470,17538,Media-Baja,93,2023-09-30,257,486,5029,15765,22567,6802
2895,1812,1372,640,5360,1571,16219,Media-Baja,94,2023-09-30,318,528,3976,14496,20195,5699
3856,1722,1193,651,5517,1773,20809,Media-Baja,95,2023-09-30,328,581,3965,15621,24774,9153
1648,928,433,271,4676,799,9711,Baja,96,2023-09-30,161,167,944,9083,10655,1572
3109,1817,1357,512,4430,1461,16953,Media-Baja,97,2023-09-30,296,595,5075,13577,22028,8451
1383,847,411,210,3700,670,10244,Baja,98,2023-09-30,167,194,818,7582,11062,3480
3187,1692,1150,592,5672,1491,17774,Media-Baja,99,2023-09-30,337,687,5376,14808,23150,8342
4483,3214,2176,1209,6865,2848,28868,Media-Alta,0,2023-10-31,581,936,8213,22312,37081,14769
1340,967,464,203,4190,682,8389,Baja,1,2023-10-31,177,191,947,8214,9336,1122
3144,1556,995,625,5690,1392,16474,Media-Baja,2,2023-10-31,313,605,4597,14320,21071,6751
4802,3002,2567,1215,5401,3412,37489,Media-Alta,3,2023-10-31,579,960,8227,21938,45716,23778
1541,947,359,201,3714,686,11385,Baja,4,2023-10-31,179,177,902,7804,12287,4483
3121,1938,1226,570,4867,1459,17378,Media-Baja,5,2023-10-31,256,674,4344,14111,21722,7611
2804,1750,1079,524,5620,1892,18170,Media-Baja,6,2023-10-31,277,566,5167,14512,23337,8825
5197,4521,3387,2558,9859,5255,97334,Alta,7,2023-10-31,5899,5182,15510,41858,112844,70986
4910,2979,2933,1267,8687,3085,37345,Media-Alta,8,2023-10-31,687,917,7382,25465,44727,19262
5194,3744,3720,2323,9526,5124,89084,Alta,9,2023-10-31,4849,5269,17907,39749,106991,67242
3024,1678,1386,677,5992,1527,19740,Media-Baja,10,2023-10-31,286,663,5232,15233,24972,9739
2640,1811,1372,561,5814,1555,16812,Media-Baja,11,2023-10-31,301,572,4833,14626,21645,7019
3327,1819,1226,698,6093,1593,18256,Media-Baja,12,2023-10-31,275,508,6367,15539,24623,9084
4510,3929,2553,1184,6260,3065,39441,Media-Alta,13,2023-10-31,638,953,8110,23092,47551,24459
3139,1845,1097,550,6196,1515,15707,Media-Baja,14,2023-10-31,293,570,4521,15205,20228,5023
1579,681,455,229,4648,729,8536,Baja,15,2023-10-31,161,189,964,8671,9500,829
2753,1752,1288,677,6208,1563,16548,Media-Baja,16,2023-10-31,391,525,4755,15157,21303,6146
3138,1858,1089,625,5168,1324,17896,Media-Baja,17,2023-10-31,258,638,5166,14098,23062,8964
3379,1638,1030,537,4869,1280,20133,Media-Baja,18,2023-10-31,314,516,5974,13563,26107,12544
3267,1686,1135,591,6255,1514,17828,Media-Baja,19,2023-10-31,317,550,5019,15315,22847,7532
2924,1614,986,608,5350,1486,20302,Media-Baja,20,2023-10-31,282,503,5700,13753,26002,12249
4295,3252,2347,1364,6506,3388,33499,Media-Alta,21,2023-10-31,545,788,7434,22485,40933,18448
5318,4280,2392,1116,5572,3767,40793,Media-Alta,22,2023-10-31,544,825,7525,23814,48318,24504
2674,1619,1229,589,5382,1881,19674,Media-Baja,23,2023-10-31,269,661,5750,14304,25424,11120
1619,955,430,195,3674,634,9841,Baja,24,2023-10-31,155,186,767,7848,10608,2760
6557,5321,4433,1878,10719,5617,72411,Alta,25,2023-10-31,5113,5416,19489,45054,91900,46846
4816,3590,2786,1384,6748,3127,32629,Media-Alta,26,2023-10-31,573,795,9995,23819,42624,18805
1632,932,418,259,3620,744,9347,Baja,27,2023-10-31,145,161,747,7911,10094,2183
4673,3297,2305,1147,6690,3201,44571,Media-Alta,28,2023-10-31,687,1032,8580,23032,53151,30119
1375,818,412,260,4297,794,10196,Baja,29,2023-10-31,171,193,728,8320,10924,2604
2863,1686,1239,512,4674,1747,18662,Media-Baja,30,2023-10-31,310,580,5106,13611,23768,10157
3924,4183,2282,1322,7220,2941,33308,Media-Alta,31,2023-10-31,664,857,7672,23393,40980,17587
1718,960,426,272,4536,613,9280,Baja,32,2023-10-31,185,206,828,8916,10108,1192
6425,5225,3534,2024,10345,5082,71620,Alta,33,2023-10-31,6405,5804,20588,44844,92208,47364
2571,1844,1174,583,3963,1172,19342,Media-Baja,34,2023-10-31,292,598,4810,12197,24152,11955
2955,1978,1244,534,5338,1168,17681,Media-Baja,35,2023-10-31,295,561,4839,14073,22520,8447
2941,1791,968,645,4268,1458,17959,Media-Baja,36,2023-10-31,306,592,4993,12969,22952,9983
2930,1513,1247,688,5215,1508,18258,Media-Baja,37,2023-10-31,329,558,4605,13988,22863,8875
2544,1931,1074,507,5953,1566,17673,Media-Baja,38,2023-10-31,304,568,4295,14447,21968,7521
7364,5052,3483,2300,9560,4486,88948,Alta,39,2023-10-31,5612,4834,12899,42691,101847,59156
5546,3715,4192,1997,10640,4975,83884,Alta,40,2023-10-31,5997,4591,16286,41653,100170,58517
6140,4767,3465,2257,12219,4774,80468,Alta,41,2023-10-31,5619,4967,20354,44208,100822,56614
4631,2996,2378,1393,6170,2737,35663,Media-Alta,42,2023-10-31,544,936,8496,21785,44159,22374
6510,4774,3659,2222,8872,4447,94901,Alta,43,2023-10-31,5391,4991,15194,40866,110095,69229
7468,5099,4636,1913,10089,4994,78206,Alta,44,2023-10-31,5265,5025,18972,44489,97178,52689
4053,3213,2116,1053,6930,3037,35307,Media-Alta,45,2023-10-31,675,961,6912,22038,42219,20181
4213,3303,2184,1497,6266,2925,33114,Media-Alta,46,2023-10-31,721,667,9134,21776,42248,20472
2793,1758,1215,556,5006,1663,17726,Media-Baja,47,2023-10-31,293,627,5200,13911,22926,9015
2699,1672,1282,617,4707,1311,17175,Media-Baja,48,2023-10-31,294,532,4107,13114,21282,8168
3180,2038,941,480,6115,1773,18621,Media-Baja,49,2023-10-31,274,566,4186,15367,22807,7440
3138,2097,1039,567,5905,1484,19791,Media-Baja,50,2023-10-31,296,570,5656,15096,25447,10351
1550,877,363,229,3972,681,10596,Baja,51,2023-10-31,147,186,664,8005,11260,3255
4404,3571,2219,1012,5723,2979,39592,Media-Alta,52,2023-10-31,657,809,9160,21374,48752,27378
1537,998,399,209,4030,759,9845,Baja,53,2023-10-31,188,189,861,8309,10706,2397
4896,3184,2586,1291,8108,2562,35904,Media-Alta,54,2023-10-31,532,788,8125,23947,44029,20082
3044,1821,1117,631,4624,1544,19680,Media-Baja,55,2023-10-31,277,671,4763,13729,24443,10714
1555,795,405,276,4177,717,10002,Baja,56,2023-10-31,182,179,877,8286,10879,2593
3007,2019,1227,509,4887,1178,17376,Media-Baja,57,2023-10-31,269,539,4722,13635,22098,8463
2774,2202,1122,579,5426,1495,19395,Media-Baja,58,2023-10-31,322,539,4499,14459,23894,9435
3719,2970,2446,1111,5809,2985,37559,Media-Alta,59,2023-10-31,568,821,7238,20429,44797,24368
2930,1739,1232,802,5415,1416,17555,Media-Baja,60,2023-10-31,340,613,4877,14487,22432,7945
2412,1821,1446,716,5272,1353,16786,Media-Baja,61,2023-10-31,288,592,3984,13900,20770,6870
3984,3540,2297,1288,6779,2768,31104,Media-Alta,62,2023-10-31,566,965,8355,22187,39459,17272
2982,1859,1250,610,6265,1560,16978,Media-Baja,63,2023-10-31,324,685,5293,15535,22271,6736
4338,3141,2045,1077,6116,3227,28781,Media-Alta,64,2023-10-31,578,802,8048,21324,36829,15505
5499,3358,2818,1137,7987,2369,36860,Media-Alta,65,2023-10-31,550,776,7528,24494,44388,19894
4016,3558,2347,1190,5783,3320,37181,Media-Alta,66,2023-10-31,575,863,8297,21652,45478,23826
5087,3755,2651,1245,7351,2723,33611,Media-Alta,67,2023-10-31,651,799,8386,24262,41997,17735
1452,855,397,242,4719,760,10857,Baja,69,2023-10-31,187,181,891,8793,11748,2955
2965,2059,1335,596,5029,1685,15767,Media-Baja,70,2023-10-31,347,631,4567,14647,20334,5687
6128,4643,3785,2360,9121,4008,75781,Alta,71,2023-10-31,7004,5089,17294,42138,93075,50937
1505,1036,399,247,4012,760,10174,Baja,72,2023-10-31,185,198,854,8342,11028,2686
1637,881,506,250,4458,724,10015,Baja,73,2023-10-31,176,197,881,8829,10896,2067
2856,1632,1287,611,5322,1031,17108,Media-Baja,74,2023-10-31,330,603,4924,13672,22032,8360
4783,2618,2544,973,6946,3273,33695,Media-Alta,75,2023-10-31,570,973,8846,22680,42541,19861
3199,1907,1187,548,4938,1283,17167,Media-Baja,76,2023-10-31,314,649,4361,14025,21528,7503
3071,1785,1180,611,6005,1690,16648,Media-Baja,77,2023-10-31,278,643,4867,15263,21515,6252
4017,3668,2612,1093,6974,2827,33842,Media-Alta,79,2023-10-31,633,885,8354,22709,42196,19487
4641,3036,2049,1393,5766,2794,39001,Media-Alta,80,2023-10-31,653,845,8726,21177,47727,26550
2988,1847,1151,526,5393,1545,19631,Media-Baja,81,2023-10-31,334,697,5148,14481,24779,10298
1306,1038,426,265,4183,617,10638,Baja,82,2023-10-31,163,187,787,8185,11425,3240
1595,1001,483,251,3483,653,9934,Baja,83,2023-10-31,206,180,837,7852,10771,2919
2975,1645,1240,587,5473,1574,16905,Media-Baja,84,2023-10-31,319,544,4819,14357,21724,7367
1420,894,521,233,4234,842,9052,Baja,85,2023-10-31,153,197,744,8494,9796,1302
1573,685,390,222,4493,817,9508,Baja,86,2023-10-31,199,170,858,8549,10366,1817
3546,1737,1151,589,5340,1593,15702,Media-Baja,87,2023-10-31,326,585,4624,14867,20326,5459
2752,2082,1174,521,6260,1485,16849,Media-Baja,88,2023-10-31,292,568,4498,15134,21347,6213
1346,1043,376,241,3859,881,9751,Baja,89,2023-10-31,175,158,790,8079,10541,2462
1396,967,383,272,4004,676,8109,Baja,90,2023-10-31,203,197,849,8098,8958,860
3089,1461,1289,593,5521,1198,17090,Media-Baja,91,2023-10-31,341,683,5311,14175,22401,8226
4150,3451,2781,1407,6634,3089,36538,Media-Alta,92,2023-10-31,568,896,8292,22976,44830,21854
3029,1994,1215,675,6639,1470,17538,Media-Baja,93,2023-10-31,317,716,4795,16055,22333,6278
2895,1812,1372,640,5360,1571,16219,Media-Baja,94,2023-10-31,274,533,4283,14457,20502,6045
3856,1722,1193,651,5517,1773,20809,Media-Baja,95,2023-10-31,313,649,5339,15674,26148,10474
1648,928,433,271,4676,799,9711,Baja,96,2023-10-31,174,170,645,9099,10356,1257
3109,1817,1357,512,4430,1461,16953,Media-Baja,97,2023-10-31,292,611,5935,13589,22888,9299
1383,847,411,210,3700,670,10244,Baja,98,2023-10-31,158,194,892,7573,11136,3563
3187,1692,1150,592,5672,1491,17774,Media-Baja,99,2023-10-31,345,745,5212,14874,22986,8112
4483,3214,2176,1209,6865,2848,28868,Media-Alta,0,2023-11-30,656,833,7938,22284,36806,14522
1340,967,464,203,4190,682,8389,Baja,1,2023-11-30,175,199,944,8220,9333,1113
3144,1556,995,625,5690,1392,16474,Media-Baja,2,2023-11-30,355,545,4956,14302,21430,7128
4802,3002,2567,1215,5401,3412,37489,Media-Alta,3,2023-11-30,673,903,7347,21975,44836,22861
1541,947,359,201,3714,686,11385,Baja,4,2023-11-30,173,194,806,7815,12191,4376
3121,1938,1226,570,4867,1459,17378,Media-Baja,5,2023-11-30,308,662,4920,14151,22298,8147
2804,1750,1079,524,5620,1892,18170,Media-Baja,6,2023-11-30,242,646,5719,14557,23889,9332
5197,4521,3387,2558,9859,5255,97334,Alta,7,2023-11-30,6373,5328,17074,42478,114408,71930
4910,2979,2933,1267,8687,3085,37345,Media-Alta,8,2023-11-30,662,866,9242,25389,46587,21198
5194,3744,3720,2323,9526,5124,89084,Alta,9,2023-11-30,6345,5623,14186,41599,103270,61671
3024,1678,1386,677,5992,1527,19740,Media-Baja,10,2023-11-30,311,638,4921,15233,24661,9428
2640,1811,1372,561,5814,1555,16812,Media-Baja,11,2023-11-30,262,598,4632,14613,21444,6831
3327,1819,1226,698,6093,1593,18256,Media-Baja,12,2023-11-30,287,611,5535,15654,23791,8137
4510,3929,2553,1184,6260,3065,39441,Media-Alta,13,2023-11-30,512,796,9048,22809,48489,25680
3139,1845,1097,550,6196,1515,15707,Media-Baja,14,2023-11-30,332,542,4903,15216,20610,5394
1579,681,455,229,4648,729,8536,Baja,15,2023-11-30,145,188,889,8654,9425,771
2753,1752,1288,677,6208,1563,16548,Media-Baja,16,2023-11-30,307,605,4520,15153,21068,5915
3138,1858,1089,625,5168,1324,17896,Media-Baja,17,2023-11-30,310,608,5131,14120,23027,8907
3379,1638,1030,537,4869,1280,20133,Media-Baja,18,2023-11-30,290,629,5151,13652,25284,11632
3267,1686,1135,591,6255,1514,17828,Media-Baja,19,2023-11-30,282,503,5704,15233,23532,8299
2924,1614,986,608,5350,1486,20302,Media-Baja,20,2023-11-30,316,443,5304,13727,25606,11879
4295,3252,2347,1364,6506,3388,33499,Media-Alta,21,2023-11-30,545,955,7524,22652,41023,18371
5318,4280,2392,1116,5572,3767,40793,Media-Alta,22,2023-11-30,554,935,7997,23934,48790,24856
2674,1619,1229,589,5382,1881,19674,Media-Baja,23,2023-11-30,301,634,4517,14309,24191,9882
1619,955,430,195,3674,634,9841,Baja,24,2023-11-30,164,206,838,7877,10679,2802
6557,5321,4433,1878,10719,5617,72411,Alta,25,2023-11-30,6533,5337,19655,46395,92066,45671
4816,3590,2786,1384,6748,3127,32629,Media-Alta,26,2023-11-30,603,928,6672,23982,39301,15319
1632,932,418,259,3620,744,9347,Baja,27,2023-11-30,171,199,759,7975,10106,2131
4673,3297,2305,1147,6690,3201,44571,Media-Alta,28,2023-11-30,567,835,7960,22715,52531,29816
1375,818,412,260,4297,794,10196,Baja,29,2023-11-30,199,176,899,8331,11095,2764
2863,1686,1239,512,4674,1747,18662,Media-Baja,30,2023-11-30,283,580,4535,13584,23197,9613
3924,4183,2282,1322,7220,2941,33308,Media-Alta,31,2023-11-30,647,952,8586,23471,41894,18423
1718,960,426,272,4536,613,9280,Baja,32,2023-11-30,195,201,783,8921,10063,1142
6425,5225,3534,2024,10345,5082,71620,Alta,33,2023-11-30,5800,5130,18904,43565,90524,46959
2571,1844,1174,583,3963,1172,19342,Media-Baja,34,2023-11-30,242,479,4058,12028,23400,11372
2955,1978,1244,534,5338,1168,17681,Media-Baja,35,2023-11-30,294,597,5492,14108,23173,9065
2941,1791,968,645,4268,1458,17959,Media-Baja,36,2023-11-30,277,519,5104,12867,23063,10196
2930,1513,1247,688,5215,1508,18258,Media-Baja,37,2023-11-30,278,568,5258,13947,23516,9569
2544,1931,1074,507,5953,1566,17673,Media-Baja,38,2023-11-30,265,568,4138,14408,21811,7403
7364,5052,3483,2300,9560,4486,88948,Alta,39,2023-11-30,6274,5816,18309,44335,107257,62922
5546,3715,4192,1997,10640,4975,83884,Alta,40,2023-11-30,4943,5451,19175,41459,103059,61600
6140,4767,3465,2257,12219,4774,80468,Alta,41,2023-11-30,5617,4365,14365,43604,94833,51229
4631,2996,2378,1393,6170,2737,35663,Media-Alta,42,2023-11-30,641,762,7303,21708,42966,21258
6510,4774,3659,2222,8872,4447,94901,Alta,43,2023-11-30,6506,5274,17442,42264,112343,70079
7468,5099,4636,1913,10089,4994,78206,Alta,44,2023-11-30,5483,5273,16974,44955,95180,50225
4053,3213,2116,1053,6930,3037,35307,Media-Alta,45,2023-11-30,595,978,9137,21975,44444,22469
4213,3303,2184,1497,6266,2925,33114,Media-Alta,46,2023-11-30,661,922,7327,21971,40441,18470
2793,1758,1215,556,5006,1663,17726,Media-Baja,47,2023-11-30,241,502,4834,13734,22560,8826
2699,1672,1282,617,4707,1311,17175,Media-Baja,48,2023-11-30,346,574,5761,13208,22936,9728
3180,2038,941,480,6115,1773,18621,Media-Baja,49,2023-11-30,335,532,4864,15394,23485,8091
3138,2097,1039,567,5905,1484,19791,Media-Baja,50,2023-11-30,341,590,4379,15161,24170,9009
1550,877,363,229,3972,681,10596,Baja,51,2023-11-30,197,176,786,8045,11382,3337
4404,3571,2219,1012,5723,2979,39592,Media-Alta,52,2023-11-30,663,926,9347,21497,48939,27442
1537,998,399,209,4030,759,9845,Baja,53,2023-11-30,171,170,712,8273,10557,2284
4896,3184,2586,1291,8108,2562,35904,Media-Alta,54,2023-11-30,616,861,7523,24104,43427,19323
3044,1821,1117,631,4624,1544,19680,Media-Baja,55,2023-11-30,307,661,4786,13749,24466,10717
1555,795,405,276,4177,717,10002,Baja,56,2023-11-30,207,165,883,8297,10885,2588
3007,2019,1227,509,4887,1178,17376,Media-Baja,57,2023-11-30,265,558,4965,13650,22341,8691
2774,2202,1122,579,5426,1495,19395,Media-Baja,58,2023-11-30,288,544,4118,14430,23513,9083
3719,2970,2446,1111,5809,2985,37559,Media-Alta,59,2023-11-30,587,929,8199,20556,45758,25202
2930,1739,1232,802,5415,1416,17555,Media-Baja,60,2023-11-30,298,697,4700,14529,22255,7726
2412,1821,1446,716,5272,1353,16786,Media-Baja,61,2023-11-30,300,592,4961,13912,21747,7835
3984,3540,2297,1288,6779,2768,31104,Media-Alta,62,2023-11-30,633,1009,7169,22298,38273,15975
2982,1859,1250,610,6265,1560,16978,Media-Baja,63,2023-11-30,294,590,4925,15410,21903,6493
4338,3141,2045,1077,6116,3227,28781,Media-Alta,64,2023-11-30,643,835,5350,21422,34131,12709
5499,3358,2818,1137,7987,2369,36860,Media-Alta,65,2023-11-30,659,905,6086,24732,42946,18214
4016,3558,2347,1190,5783,3320,37181,Media-Alta,66,2023-11-30,661,1020,8400,21895,45581,23686
5087,3755,2651,1245,7351,2723,33611,Media-Alta,67,2023-11-30,616,865,7698,24293,41309,17016
1452,855,397,242,4719,760,10857,Baja,69,2023-11-30,150,182,901,8757,11758,3001
2965,2059,1335,596,5029,1685,15767,Media-Baja,70,2023-11-30,276,569,4154,14514,19921,5407
6128,4643,3785,2360,9121,4008,75781,Alta,71,2023-11-30,5655,5487,18239,41187,94020,52833
1505,1036,399,247,4012,760,10174,Baja,72,2023-11-30,145,176,790,8280,10964,2684
1637,881,506,250,4458,724,10015,Baja,73,2023-11-30,143,161,914,8760,10929,2169
2856,1632,1287,611,5322,1031,17108,Media-Baja,74,2023-11-30,265,532,4321,13536,21429,7893
4783,2618,2544,973,6946,3273,33695,Media-Alta,75,2023-11-30,570,718,9348,22425,43043,20618
3199,1907,1187,548,4938,1283,17167,Media-Baja,76,2023-11-30,264,599,5741,13925,22908,8983
3071,1785,1180,611,6005,1690,16648,Media-Baja,77,2023-11-30,329,586,4907,15257,21555,6298
4017,3668,2612,1093,6974,2827,33842,Media-Alta,79,2023-11-30,455,798,7444,22444,41286,18842
4641,3036,2049,1393,5766,2794,39001,Media-Alta,80,2023-11-30,608,748,7219,21035,46220,25185
2988,1847,1151,526,5393,1545,19631,Media-Baja,81,2023-11-30,343,651,5232,14444,24863,10419
1306,1038,426,265,4183,617,10638,Baja,82,2023-11-30,156,177,970,8168,11608,3440
1595,1001,483,251,3483,653,9934,Baja,83,2023-11-30,141,167,836,7774,10770,2996
2975,1645,1240,587,5473,1574,16905,Media-Baja,84,2023-11-30,331,543,4777,14368,21682,7314
1420,894,521,233,4234,842,9052,Baja,85,2023-11-30,204,206,857,8554,9909,1355
1573,685,390,222,4493,817,9508,Baja,86,2023-11-30,189,168,876,8537,10384,1847
3546,1737,1151,589,5340,1593,15702,Media-Baja,87,2023-11-30,332,577,4770,14865,20472,5607
2752,2082,1174,521,6260,1485,16849,Media-Baja,88,2023-11-30,289,550,5011,15113,21860,6747
1346,1043,376,241,3859,881,9751,Baja,89,2023-11-30,194,193,760,8133,10511,2378
1396,967,383,272,4004,676,8109,Baja,90,2023-11-30,201,155,1078,8054,9187,1133
3089,1461,1289,593,5521,1198,17090,Media-Baja,91,2023-11-30,358,702,4535,14211,21625,7414
4150,3451,2781,1407,6634,3089,36538,Media-Alta,92,2023-11-30,580,914,5326,23006,41864,18858
3029,1994,1215,675,6639,1470,17538,Media-Baja,93,2023-11-30,330,637,5231,15989,22769,6780
2895,1812,1372,640,5360,1571,16219,Media-Baja,94,2023-11-30,354,550,4740,14554,20959,6405
3856,1722,1193,651,5517,1773,20809,Media-Baja,95,2023-11-30,293,564,5220,15569,26029,10460
1648,928,433,271,4676,799,9711,Baja,96,2023-11-30,167,175,869,9097,10580,1483
3109,1817,1357,512,4430,1461,16953,Media-Baja,97,2023-11-30,314,644,4280,13644,21233,7589
1383,847,411,210,3700,670,10244,Baja,98,2023-11-30,182,176,941,7579,11185,3606
3187,1692,1150,592,5672,1491,17774,Media-Baja,99,2023-11-30,268,596,5225,14648,22999,8351
4483,3214,2176,1209,6865,2848,28868,Media-Alta,0,2023-12-31,604,928,7066,22327,35934,13607
1340,967,464,203,4190,682,8389,Baja,1,2023-12-31,171,177,952,8194,9341,1147
3144,1556,995,625,5690,1392,16474,Media-Baja,2,2023-12-31,306,641,4784,14349,21258,6909
4802,3002,2567,1215,5401,3412,37489,Media-Alta,3,2023-12-31,643,860,7743,21902,45232,23330
1541,947,359,201,3714,686,11385,Baja,4,2023-12-31,174,192,891,7814,12276,4462
3121,1938,1226,570,4867,1459,17378,Media-Baja,5,2023-12-31,298,603,4697,14082,22075,7993
2804,1750,1079,524,5620,1892,18170,Media-Baja,6,2023-12-31,358,587,5347,14614,23517,8903
5197,4521,3387,2558,9859,5255,97334,Alta,7,2023-12-31,6279,5856,14634,42912,111968,69056
4910,2979,2933,1267,8687,3085,37345,Media-Alta,8,2023-12-31,634,960,8101,25455,45446,19991
5194,3744,3720,2323,9526,5124,89084,Alta,9,2023-12-31,7496,5572,18537,42699,107621,64922
3024,1678,1386,677,5992,1527,19740,Media-Baja,10,2023-12-31,284,597,5806,15165,25546,10381
2640,1811,1372,561,5814,1555,16812,Media-Baja,11,2023-12-31,304,561,4604,14618,21416,6798
3327,1819,1226,698,6093,1593,18256,Media-Baja,12,2023-12-31,282,578,4966,15616,23222,7606
4510,3929,2553,1184,6260,3065,39441,Media-Alta,13,2023-12-31,538,1013,7597,23052,47038,23986
3139,1845,1097,550,6196,1515,15707,Media-Baja,14,2023-12-31,289,569,5933,15200,21640,6440
1579,681,455,229,4648,729,8536,Baja,15,2023-12-31,207,211,796,8739,9332,593
2753,1752,1288,677,6208,1563,16548,Media-Baja,16,2023-12-31,336,539,4503,15116,21051,5935
3138,1858,1089,625,5168,1324,17896,Media-Baja,17,2023-12-31,274,626,5276,14102,23172,9070
3379,1638,1030,537,4869,1280,20133,Media-Baja,18,2023-12-31,282,595,5238,13610,25371,11761
3267,1686,1135,591,6255,1514,17828,Media-Baja,19,2023-12-31,310,570,5803,15328,23631,8303
2924,1614,986,608,5350,1486,20302,Media-Baja,20,2023-12-31,300,617,5471,13885,25773,11888
4295,3252,2347,1364,6506,3388,33499,Media-Alta,21,2023-12-31,550,994,8672,22696,42171,19475
5318,4280,2392,1116,5572,3767,40793,Media-Alta,22,2023-12-31,509,751,7236,23705,48029,24324
2674,1619,1229,589,5382,1881,19674,Media-Baja,23,2023-12-31,299,462,4813,14135,24487,10352
1619,955,430,195,3674,634,9841,Baja,24,2023-12-31,181,151,800,7839,10641,2802
6557,5321,4433,1878,10719,5617,72411,Alta,25,2023-12-31,7138,5302,15823,46965,88234,41269
4816,3590,2786,1384,6748,3127,32629,Media-Alta,26,2023-12-31,629,734,8454,23814,41083,17269
1632,932,418,259,3620,744,9347,Baja,27,2023-12-31,187,186,819,7978,10166,2188
4673,3297,2305,1147,6690,3201,44571,Media-Alta,28,2023-12-31,637,1039,7399,22989,51970,28981
1375,818,412,260,4297,794,10196,Baja,29,2023-12-31,173,169,916,8298,11112,2814
2863,1686,1239,512,4674,1747,18662,Media-Baja,30,2023-12-31,274,554,5234,13549,23896,10347
3924,4183,2282,1322,7220,2941,33308,Media-Alta,31,2023-12-31,498,922,7803,23292,41111,17819
1718,960,426,272,4536,613,9280,Baja,32,2023-12-31,156,194,665,8875,9945,1070
6425,5225,3534,2024,10345,5082,71620,Alta,33,2023-12-31,5807,5544,17313,43986,88933,44947
2571,1844,1174,583,3963,1172,19342,Media-Baja,34,2023-12-31,252,564,5236,12123,24578,12455
2955,1978,1244,534,5338,1168,17681,Media-Baja,35,2023-12-31,305,617,4872,14139,22553,8414
2941,1791,968,645,4268,1458,17959,Media-Baja,36,2023-12-31,294,626,4845,12991,22804,9813
2930,1513,1247,688,5215,1508,18258,Media-Baja,37,2023-12-31,264,558,4279,13923,22537,8614
2544,1931,1074,507,5953,1566,17673,Media-Baja,38,2023-12-31,334,605,4478,14514,22151,7637
7364,5052,3483,2300,9560,4486,88948,Alta,39,2023-12-31,5712,4896,17529,42853,106477,63624
5546,3715,4192,1997,10640,4975,83884,Alta,40,2023-12-31,6787,5251,16570,43103,100454,57351
6140,4767,3465,2257,12219,4774,80468,Alta,41,2023-12-31,6506,5596,17082,45724,97550,51826
4631,2996,2378,1393,6170,2737,35663,Media-Alta,42,2023-12-31,623,1025,8702,21953,44365,22412
6510,4774,3659,2222,8872,4447,94901,Alta,43,2023-12-31,5529,6753,17394,42766,112295,69529
7468,5099,4636,1913,10089,4994,78206,Alta,44,2023-12-31,5648,5334,20290,45181,98496,53315
4053,3213,2116,1053,6930,3037,35307,Media-Alta,45,2023-12-31,674,932,8101,22008,43408,21400
4213,3303,2184,1497,6266,2925,33114,Media-Alta,46,2023-12-31,515,687,6440,21590,39554,17964
2793,1758,1215,556,5006,1663,17726,Media-Baja,47,2023-12-31,331,665,4355,13987,22081,8094
2699,1672,1282,617,4707,1311,17175,Media-Baja,48,2023-12-31,326,569,5291,13183,22466,9283
3180,2038,941,480,6115,1773,18621,Media-Baja,49,2023-12-31,342,542,5646,15411,24267,8856
3138,2097,1039,567,5905,1484,19791,Media-Baja,50,2023-12-31,292,575,4707,15097,24498,9401
1550,877,363,229,3972,681,10596,Baja,51,2023-12-31,183,170,840,8025,11436,3411
4404,3571,2219,1012,5723,2979,39592,Media-Alta,52,2023-12-31,581,1038,8177,21527,47769,26242
1537,998,399,209,4030,759,9845,Baja,53,2023-12-31,209,174,848,8315,10693,2378
4896,3184,2586,1291,8108,2562,35904,Media-Alta,54,2023-12-31,595,845,7639,24067,43543,19476
3044,1821,1117,631,4624,1544,19680,Media-Baja,55,2023-12-31,296,573,4970,13650,24650,11000
1555,795,405,276,4177,717,10002,Baja,56,2023-12-31,187,170,888,8282,10890,2608
3007,2019,1227,509,4887,1178,17376,Media-Baja,57,2023-12-31,256,577,4714,13660,22090,8430
2774,2202,1122,579,5426,1495,19395,Media-Baja,58,2023-12-31,284,560,4890,14442,24285,9843
3719,2970,2446,1111,5809,2985,37559,Media-Alta,59,2023-12-31,609,858,8940,20507,46499,25992
2930,1739,1232,802,5415,1416,17555,Media-Baja,60,2023-12-31,276,638,3865,14448,21420,6972
2412,1821,1446,716,5272,1353,16786,Media-Baja,61,2023-12-31,292,572,4949,13884,21735,7851
3984,3540,2297,1288,6779,2768,31104,Media-Alta,62,2023-12-31,664,879,6762,22199,37866,15667
2982,1859,1250,610,6265,1560,16978,Media-Baja,63,2023-12-31,274,591,4967,15391,21945,6554
4338,3141,2045,1077,6116,3227,28781,Media-Alta,64,2023-12-31,739,923,8366,21606,37147,15541
5499,3358,2818,1137,7987,2369,36860,Media-Alta,65,2023-12-31,585,901,8373,24654,45233,20579
4016,3558,2347,1190,5783,3320,37181,Media-Alta,66,2023-12-31,607,979,8462,21800,45643,23843
5087,3755,2651,1245,7351,2723,33611,Media-Alta,67,2023-12-31,621,934,8672,24367,42283,17916
1452,855,397,242,4719,760,10857,Baja,69,2023-12-31,167,162,838,8754,11695,2941
2965,2059,1335,596,5029,1685,15767,Media-Baja,70,2023-12-31,306,528,4293,14503,20060,5557
6128,4643,3785,2360,9121,4008,75781,Alta,71,2023-12-31,6124,5346,16276,41515,92057,50542
1505,1036,399,247,4012,760,10174,Baja,72,2023-12-31,171,175,845,8305,11019,2714
1637,881,506,250,4458,724,10015,Baja,73,2023-12-31,146,189,822,8791,10837,2046
2856,1632,1287,611,5322,1031,17108,Media-Baja,74,2023-12-31,286,762,5538,13787,22646,8859
4783,2618,2544,973,6946,3273,33695,Media-Alta,75,2023-12-31,686,1035,8430,22858,42125,19267
3199,1907,1187,548,4938,1283,17167,Media-Baja,76,2023-12-31,308,586,4947,13956,22114,8158
3071,1785,1180,611,6005,1690,16648,Media-Baja,77,2023-12-31,257,552,4992,15151,21640,6489
4017,3668,2612,1093,6974,2827,33842,Media-Alta,79,2023-12-31,651,798,9169,22640,43011,20371
4641,3036,2049,1393,5766,2794,39001,Media-Alta,80,2023-12-31,548,782,7276,21009,46277,25268
2988,1847,1151,526,5393,1545,19631,Media-Baja,81,2023-12-31,320,507,5328,14277,24959,10682
1306,1038,426,265,4183,617,10638,Baja,82,2023-12-31,183,137,778,8155,11416,3261
1595,1001,483,251,3483,653,9934,Baja,83,2023-12-31,167,206,685,7839,10619,2780
2975,1645,1240,587,5473,1574,16905,Media-Baja,84,2023-12-31,304,590,5524,14388,22429,8041
1420,894,521,233,4234,842,9052,Baja,85,2023-12-31,177,188,778,8509,9830,1321
1573,685,390,222,4493,817,9508,Baja,86,2023-12-31,140,198,678,8518,10186,1668
3546,1737,1151,589,5340,1593,15702,Media-Baja,87,2023-12-31,307,690,4377,14953,20079,5126
2752,2082,1174,521,6260,1485,16849,Media-Baja,88,2023-12-31,310,680,4926,15264,21775,6511
1346,1043,376,241,3859,881,9751,Baja,89,2023-12-31,167,171,935,8084,10686,2602
1396,967,383,272,4004,676,8109,Baja,90,2023-12-31,174,198,922,8070,9031,961
3089,1461,1289,593,5521,1198,17090,Media-Baja,91,2023-12-31,252,641,4858,14044,21948,7904
4150,3451,2781,1407,6634,3089,36538,Media-Alta,92,2023-12-31,562,902,6745,22976,43283,20307
3029,1994,1215,675,6639,1470,17538,Media-Baja,93,2023-12-31,308,579,6004,15909,23542,7633
2895,1812,1372,640,5360,1571,16219,Media-Baja,94,2023-12-31,311,560,5630,14521,21849,7328
3856,1722,1193,651,5517,1773,20809,Media-Baja,95,2023-12-31,298,599,4957,15609,25766,10157
1648,928,433,271,4676,799,9711,Baja,96,2023-12-31,210,163,970,9128,10681,1553
3109,1817,1357,512,4430,1461,16953,Media-Baja,97,2023-12-31,250,497,5220,13433,22173,8740
1383,847,411,210,3700,670,10244,Baja,98,2023-12-31,192,179,721,7592,10965,3373
3187,1692,1150,592,5672,1491,17774,Media-Baja,99,2023-12-31,300,665,5052,14749,22826,8077
4663,3342,2264,1257,7139,2962,30022,Media-Alta,0,2024-01-31,670,1051,8357,23348,38379,15031
1393,1006,482,211,4358,710,8724,Baja,1,2024-01-31,162,190,847,8512,9571,1059
3270,1618,1035,650,5918,1447,17133,Media-Baja,2,2024-01-31,327,711,5277,14976,22410,7434
4994,3122,2670,1263,5617,3549,38989,Media-Alta,3,2024-01-31,570,946,7294,22731,46283,23552
1602,985,373,210,3863,713,11840,Baja,4,2024-01-31,181,172,883,8099,12723,4624
3246,2016,1275,593,5061,1517,18073,Media-Baja,5,2024-01-31,341,708,4820,14757,22893,8136
2916,1820,1122,545,5845,1967,18897,Media-Baja,6,2024-01-31,355,551,4895,15121,23792,8671
5405,4701,3522,2660,10253,5465,101228,Alta,7,2024-01-31,6530,5803,18376,44339,119604,75265
5106,3099,3050,1317,9035,3209,38839,Media-Alta,8,2024-01-31,651,867,7817,26334,46656,20322
5402,3894,3869,2416,9907,5329,92648,Alta,9,2024-01-31,6372,6828,17240,44017,109888,65871
3145,1745,1441,705,6232,1588,20530,Media-Baja,10,2024-01-31,358,643,4644,15857,25174,9317
2746,1884,1427,583,6047,1617,17484,Media-Baja,11,2024-01-31,321,671,5720,15296,23204,7908
3460,1892,1275,726,6337,1657,18986,Media-Baja,12,2024-01-31,313,682,5004,16342,23990,7648
4690,4086,2655,1231,6510,3187,41019,Media-Alta,13,2024-01-31,627,970,8230,23956,49249,25293
3265,1919,1141,572,6444,1576,16336,Media-Baja,14,2024-01-31,325,637,5683,15879,22019,6140
1642,708,473,238,4834,758,8877,Baja,15,2024-01-31,162,188,897,9003,9774,771
2864,1822,1340,705,6457,1626,17209,Media-Baja,16,2024-01-31,275,592,5715,15681,22924,7243
3264,1932,1132,650,5375,1377,18612,Media-Baja,17,2024-01-31,292,622,5358,14644,23970,9326
3514,1703,1071,558,5064,1331,20939,Media-Baja,18,2024-01-31,350,612,4531,14203,25470,11267
3397,1753,1181,615,6505,1575,18541,Media-Baja,19,2024-01-31,272,566,5845,15864,24386,8522
3041,1678,1026,632,5564,1546,21114,Media-Baja,20,2024-01-31,301,650,4731,14438,25845,11407
4466,3382,2441,1418,6767,3524,34839,Media-Alta,21,2024-01-31,561,991,9366,23550,44205,20655
5530,4451,2487,1161,5795,3918,42424,Media-Alta,22,2024-01-31,513,1055,7875,24910,50299,25389
2781,1683,1278,612,5598,1956,20461,Media-Baja,23,2024-01-31,287,623,4443,14818,24904,10086
1683,993,447,203,3821,660,10235,Baja,24,2024-01-31,198,165,869,8170,11104,2934
6819,5534,4610,1954,11147,5842,75308,Alta,25,2024-01-31,6244,5724,13546,47874,88854,40980
5009,3734,2897,1440,7018,3252,33934,Media-Alta,26,2024-01-31,662,936,6520,24948,40454,15506
1697,970,435,270,3765,773,9721,Baja,27,2024-01-31,158,155,801,8223,10522,2299
4860,3429,2397,1193,6958,3329,46354,Media-Alta,28,2024-01-31,603,980,6174,23749,52528,28779
1430,851,428,271,4469,826,10603,Baja,29,2024-01-31,170,195,858,8640,11461,2821
2977,1753,1288,532,4861,1817,19408,Media-Baja,30,2024-01-31,342,545,5469,14115,24877,10762
4081,4350,2374,1375,7509,3059,34641,Media-Alta,31,2024-01-31,605,885,7827,24238,42468,18230
1787,998,443,283,4718,637,9651,Baja,32,2024-01-31,195,156,819,9217,10470,1253
6682,5434,3675,2105,10759,5285,74485,Alta,33,2024-01-31,5499,6503,18911,45942,93396,47454
2674,1917,1221,606,4121,1218,20116,Media-Baja,34,2024-01-31,342,552,5197,12651,25313,12662
3074,2057,1293,556,5552,1215,18388,Media-Baja,35,2024-01-31,300,690,4099,14737,22487,7750
3059,1862,1007,671,4439,1516,18677,Media-Baja,36,2024-01-31,313,605,5619,13472,24296,10824
3047,1573,1297,716,5424,1568,18988,Media-Baja,37,2024-01-31,308,615,5592,14548,24580,10032
2646,2009,1117,527,6192,1628,18380,Media-Baja,38,2024-01-31,303,582,4400,15004,22780,7776
7658,5254,3623,2392,9942,4665,92506,Alta,39,2024-01-31,6479,5880,14997,45893,107503,61610
5768,3864,4360,2077,11066,5174,87239,Alta,40,2024-01-31,5987,5584,17909,43880,105148,61268
6385,4958,3604,2347,12708,4965,83686,Alta,41,2024-01-31,6380,4633,17426,45980,101112,55132
4816,3116,2474,1448,6417,2846,37090,Media-Alta,42,2024-01-31,710,1095,8556,22922,45646,22724
6770,4965,3805,2311,9227,4625,98697,Alta,43,2024-01-31,6910,6342,16581,44955,115278,70323
7767,5303,4821,1990,10492,5194,81335,Alta,44,2024-01-31,4774,5206,20357,45547,101692,56145
4215,3341,2201,1095,7207,3159,36720,Media-Alta,45,2024-01-31,705,990,5927,22913,42647,19734
4381,3435,2271,1557,6517,3042,34438,Media-Alta,46,2024-01-31,625,918,8169,22746,42607,19861
2905,1829,1263,578,5206,1730,18435,Media-Baja,47,2024-01-31,353,585,4367,14449,22802,8353
2807,1738,1333,642,4895,1363,17862,Media-Baja,48,2024-01-31,297,636,4803,13711,22665,8954
3307,2120,978,500,6359,1844,19366,Media-Baja,49,2024-01-31,290,728,5794,16126,25160,9034
3264,2181,1081,590,6142,1543,20582,Media-Baja,50,2024-01-31,270,657,5872,15728,26454,10726
1612,912,377,238,4131,708,11020,Baja,51,2024-01-31,170,186,919,8334,11939,3605
4580,3714,2307,1052,5952,3099,41175,Media-Alta,52,2024-01-31,542,870,6666,22116,47841,25725
1598,1038,415,217,4191,790,10238,Baja,53,2024-01-31,196,211,796,8656,11034,2378
5091,3311,2690,1342,8432,2665,37340,Media-Alta,54,2024-01-31,705,1026,8280,25262,45620,20358
3166,1894,1162,656,4809,1606,20467,Media-Baja,55,2024-01-31,317,653,4588,14263,25055,10792
1617,827,421,287,4344,746,10402,Baja,56,2024-01-31,196,172,969,8610,11371,2761
3127,2100,1276,530,5083,1225,18071,Media-Baja,57,2024-01-31,380,625,5614,14346,23685,9339
2885,2290,1167,602,5643,1555,20171,Media-Baja,58,2024-01-31,333,517,5286,14992,25457,10465
3868,3089,2544,1156,6042,3105,39061,Media-Alta,59,2024-01-31,566,788,7651,21158,46712,25554
3047,1809,1281,835,5632,1472,18257,Media-Baja,60,2024-01-31,320,735,5593,15131,23850,8719
2509,1894,1503,745,5483,1407,17457,Media-Baja,61,2024-01-31,296,596,4990,14433,22447,8014
4144,3681,2389,1340,7050,2879,32348,Media-Alta,62,2024-01-31,626,1146,8187,23255,40535,17280
3101,1934,1300,635,6515,1622,17657,Media-Baja,63,2024-01-31,305,678,4840,16090,22497,6407
4511,3266,2127,1120,6360,3356,29932,Media-Alta,64,2024-01-31,727,966,9212,22433,39144,16711
5719,3492,2931,1182,8307,2464,38335,Media-Alta,65,2024-01-31,680,931,7675,25706,46010,20304
4176,3700,2441,1237,6014,3452,38669,Media-Alta,66,2024-01-31,590,972,8397,22582,47066,24484
5290,3905,2757,1295,7646,2832,34956,Media-Alta,67,2024-01-31,512,998,7813,25235,42769,17534
1510,890,413,252,4908,791,11291,Baja,69,2024-01-31,157,197,951,9118,12242,3124
3084,2141,1388,620,5230,1752,16398,Media-Baja,70,2024-01-31,296,676,5277,15187,21675,6488
6373,4829,3936,2455,9486,4169,78812,Alta,71,2024-01-31,6307,6118,17077,43673,95889,52216
1565,1077,415,257,4173,791,10581,Baja,72,2024-01-31,182,212,888,8672,11469,2797
1702,916,526,260,4636,753,10416,Baja,73,2024-01-31,188,203,808,9184,11224,2040
2970,1697,1338,636,5535,1072,17792,Media-Baja,74,2024-01-31,321,720,4456,14289,22248,7959
4974,2722,2646,1012,7224,3404,35043,Media-Alta,75,2024-01-31,592,1005,7667,23579,42710,19131
3327,1984,1235,570,5135,1335,17853,Media-Baja,76,2024-01-31,318,701,4552,14605,22405,7800
3194,1856,1227,636,6245,1757,17314,Media-Baja,77,2024-01-31,303,620,4122,15838,21436,5598
4178,3815,2716,1137,7253,2940,35196,Media-Alta,79,2024-01-31,735,1050,7730,23824,42926,19102
4826,3157,2131,1448,5997,2906,40561,Media-Alta,80,2024-01-31,732,941,9459,22138,50020,27882
3107,1921,1197,547,5609,1607,20416,Media-Baja,81,2024-01-31,311,592,4358,14891,24774,9883
1358,1080,443,276,4350,642,11064,Baja,82,2024-01-31,177,180,864,8506,11928,3422
1658,1041,502,261,3623,680,10331,Baja,83,2024-01-31,197,217,802,8179,11133,2954
3094,1711,1290,611,5692,1637,17581,Media-Baja,84,2024-01-31,295,568,4803,14898,22384,7486
1477,930,542,242,4404,876,9415,Baja,85,2024-01-31,185,196,874,8852,10289,1437
1636,712,406,231,4673,850,9888,Baja,86,2024-01-31,187,183,866,8878,10754,1876
3688,1806,1197,612,5554,1657,16331,Media-Baja,87,2024-01-31,320,548,4074,15382,20405,5023
2862,2165,1221,542,6510,1545,17523,Media-Baja,88,2024-01-31,345,596,5905,15786,23428,7642
1400,1085,391,251,4014,916,10141,Baja,89,2024-01-31,156,182,916,8395,11057,2662
1452,1006,398,283,4164,703,8433,Baja,90,2024-01-31,192,200,986,8398,9419,1021
3212,1520,1341,617,5742,1246,17773,Media-Baja,91,2024-01-31,276,622,4397,14576,22170,7594
4316,3589,2892,1463,6899,3212,38000,Media-Alta,92,2024-01-31,588,863,9069,23822,47069,23247
3150,2074,1263,702,6904,1528,18240,Media-Baja,93,2024-01-31,355,432,4922,16408,23162,6754
3011,1885,1427,666,5574,1633,16868,Media-Baja,94,2024-01-31,288,555,4466,15039,21334,6295
4010,1791,1241,677,5738,1844,21641,Media-Baja,95,2024-01-31,283,581,4963,16165,26604,10439
1713,965,451,282,4863,831,10100,Baja,96,2024-01-31,207,186,1055,9498,11155,1657
3234,1890,1411,532,4608,1520,17631,Media-Baja,97,2024-01-31,317,590,5550,14102,23181,9079
1438,881,427,218,3848,697,10653,Baja,98,2024-01-31,185,191,927,7885,11580,3695
3315,1760,1196,616,5899,1551,18485,Media-Baja,99,2024-01-31,302,637,5422,15276,23907,8631
4663,3342,2264,1257,7139,2962,30022,Media-Alta,0,2024-02-29,648,1032,8900,23307,38922,15615
1393,1006,482,211,4358,710,8724,Baja,1,2024-02-29,178,185,967,8523,9691,1168
3270,1618,1035,650,5918,1447,17133,Media-Baja,2,2024-02-29,362,645,4581,14945,21714,6769
4994,3122,2670,1263,5617,3549,38989,Media-Alta,3,2024-02-29,503,902,7661,22620,46650,24030
1602,985,373,210,3863,713,11840,Baja,4,2024-02-29,211,168,852,8125,12692,4567
3246,2016,1275,593,5061,1517,18073,Media-Baja,5,2024-02-29,297,596,5684,14601,23757,9156
2916,1820,1122,545,5845,1967,18897,Media-Baja,6,2024-02-29,255,548,5475,15018,24372,9354
5405,4701,3522,2660,10253,5465,101228,Alta,7,2024-02-29,6375,5894,15532,44275,116760,72485
5106,3099,3050,1317,9035,3209,38839,Media-Alta,8,2024-02-29,570,1048,8722,26434,47561,21127
5402,3894,3869,2416,9907,5329,92648,Alta,9,2024-02-29,5694,5495,18122,42006,110770,68764
3145,1745,1441,705,6232,1588,20530,Media-Baja,10,2024-02-29,325,637,4705,15818,25235,9417
2746,1884,1427,583,6047,1617,17484,Media-Baja,11,2024-02-29,311,622,5185,15237,22669,7432
3460,1892,1275,726,6337,1657,18986,Media-Baja,12,2024-02-29,345,647,4754,16339,23740,7401
4690,4086,2655,1231,6510,3187,41019,Media-Alta,13,2024-02-29,485,945,8493,23789,49512,25723
3265,1919,1141,572,6444,1576,16336,Media-Baja,14,2024-02-29,291,718,5267,15926,21603,5677
1642,708,473,238,4834,758,8877,Baja,15,2024-02-29,127,200,881,8980,9758,778
2864,1822,1340,705,6457,1626,17209,Media-Baja,16,2024-02-29,272,667,5421,15753,22630,6877
3264,1932,1132,650,5375,1377,18612,Media-Baja,17,2024-02-29,316,697,5502,14743,24114,9371
3514,1703,1071,558,5064,1331,20939,Media-Baja,18,2024-02-29,316,616,4993,14173,25932,11759
3397,1753,1181,615,6505,1575,18541,Media-Baja,19,2024-02-29,336,588,4073,15950,22614,6664
3041,1678,1026,632,5564,1546,21114,Media-Baja,20,2024-02-29,242,663,4279,14392,25393,11001
4466,3382,2441,1418,6767,3524,34839,Media-Alta,21,2024-02-29,608,961,8679,23567,43518,19951
5530,4451,2487,1161,5795,3918,42424,Media-Alta,22,2024-02-29,573,1055,7916,24970,50340,25370
2781,1683,1278,612,5598,1956,20461,Media-Baja,23,2024-02-29,273,653,5181,14834,25642,10808
1683,993,447,203,3821,660,10235,Baja,24,2024-02-29,195,225,900,8227,11135,2908
6819,5534,4610,1954,11147,5842,75308,Alta,25,2024-02-29,6664,5109,16490,47679,91798,44119
5009,3734,2897,1440,7018,3252,33934,Media-Alta,26,2024-02-29,558,896,8045,24804,41979,17175
1697,970,435,270,3765,773,9721,Baja,27,2024-02-29,191,193,820,8294,10541,2247
4860,3429,2397,1193,6958,3329,46354,Media-Alta,28,2024-02-29,625,967,7855,23758,54209,30451
1430,851,428,271,4469,826,10603,Baja,29,2024-02-29,191,207,812,8673,11415,2742
2977,1753,1288,532,4861,1817,19408,Media-Baja,30,2024-02-29,338,607,4700,14173,24108,9935
4081,4350,2374,1375,7509,3059,34641,Media-Alta,31,2024-02-29,668,921,8593,24337,43234,18897
1787,998,443,283,4718,637,9651,Baja,32,2024-02-29,220,171,817,9257,10468,1211
6682,5434,3675,2105,10759,5285,74485,Alta,33,2024-02-29,5283,5226,19333,44449,93818,49369
2674,1917,1221,606,4121,1218,20116,Media-Baja,34,2024-02-29,290,556,5931,12603,26047,13444
3074,2057,1293,556,5552,1215,18388,Media-Baja,35,2024-02-29,348,648,4735,14743,23123,8380
3059,1862,1007,671,4439,1516,18677,Media-Baja,36,2024-02-29,323,655,4368,13532,23045,9513
3047,1573,1297,716,5424,1568,18988,Media-Baja,37,2024-02-29,342,698,5237,14665,24225,9560
2646,2009,1117,527,6192,1628,18380,Media-Baja,38,2024-02-29,360,595,4263,15074,22643,7569
7658,5254,3623,2392,9942,4665,92506,Alta,39,2024-02-29,6913,5673,14671,46120,107177,61057
5768,3864,4360,2077,11066,5174,87239,Alta,40,2024-02-29,5854,6083,12856,44246,100095,55849
6385,4958,3604,2347,12708,4965,83686,Alta,41,2024-02-29,6913,5892,19581,47772,103267,55495
4816,3116,2474,1448,6417,2846,37090,Media-Alta,42,2024-02-29,591,901,8120,22609,45210,22601
6770,4965,3805,2311,9227,4625,98697,Alta,43,2024-02-29,6189,5908,16772,43800,115469,71669
7767,5303,4821,1990,10492,5194,81335,Alta,44,2024-02-29,5026,5449,15852,46042,97187,51145
4215,3341,2201,1095,7207,3159,36720,Media-Alta,45,2024-02-29,613,995,7900,22826,44620,21794
4381,3435,2271,1557,6517,3042,34438,Media-Alta,46,2024-02-29,497,846,7230,22546,41668,19122
2905,1829,1263,578,5206,1730,18435,Media-Baja,47,2024-02-29,327,595,4900,14433,23335,8902
2807,1738,1333,642,4895,1363,17862,Media-Baja,48,2024-02-29,328,713,4453,13819,22315,8496
3307,2120,978,500,6359,1844,19366,Media-Baja,49,2024-02-29,262,606,4594,15976,23960,7984
3264,2181,1081,590,6142,1543,20582,Media-Baja,50,2024-02-29,336,540,5899,15677,26481,10804
1612,912,377,238,4131,708,11020,Baja,51,2024-02-29,213,212,908,8403,11928,3525
4580,3714,2307,1052,5952,3099,41175,Media-Alta,52,2024-02-29,715,852,8704,22271,49879,27608
1598,1038,415,217,4191,790,10238,Baja,53,2024-02-29,146,187,840,8582,11078,2496
5091,3311,2690,1342,8432,2665,37340,Media-Alta,54,2024-02-29,626,841,7343,24998,44683,19685
3166,1894,1162,656,4809,1606,20467,Media-Baja,55,2024-02-29,372,596,4884,14261,25351,11090
1617,827,421,287,4344,746,10402,Baja,56,2024-02-29,178,186,1056,8606,11458,2852
3127,2100,1276,530,5083,1225,18071,Media-Baja,57,2024-02-29,326,702,5033,14369,23104,8735
2885,2290,1167,602,5643,1555,20171,Media-Baja,58,2024-02-29,252,630,4577,15024,24748,9724
3868,3089,2544,1156,6042,3105,39061,Media-Alta,59,2024-02-29,622,1066,8001,21492,47062,25570
3047,1809,1281,835,5632,1472,18257,Media-Baja,60,2024-02-29,272,622,5098,14970,23355,8385
2509,1894,1503,745,5483,1407,17457,Media-Baja,61,2024-02-29,327,630,4941,14498,22398,7900
4144,3681,2389,1340,7050,2879,32348,Media-Alta,62,2024-02-29,523,1092,7701,23098,40049,16951
3101,1934,1300,635,6515,1622,17657,Media-Baja,63,2024-02-29,307,621,4583,16035,22240,6205
4511,3266,2127,1120,6360,3356,29932,Media-Alta,64,2024-02-29,543,953,7728,22236,37660,15424
5719,3492,2931,1182,8307,2464,38335,Media-Alta,65,2024-02-29,542,920,8065,25557,46400,20843
4176,3700,2441,1237,6014,3452,38669,Media-Alta,66,2024-02-29,567,755,9560,22342,48229,25887
5290,3905,2757,1295,7646,2832,34956,Media-Alta,67,2024-02-29,685,1026,7326,25436,42282,16846
1510,890,413,252,4908,791,11291,Baja,69,2024-02-29,191,175,896,9130,12187,3057
3084,2141,1388,620,5230,1752,16398,Media-Baja,70,2024-02-29,312,595,5108,15122,21506,6384
6373,4829,3936,2455,9486,4169,78812,Alta,71,2024-02-29,8138,6125,17105,45511,95917,50406
1565,1077,415,257,4173,791,10581,Baja,72,2024-02-29,193,186,819,8657,11400,2743
1702,916,526,260,4636,753,10416,Baja,73,2024-02-29,181,193,847,9167,11263,2096
2970,1697,1338,636,5535,1072,17792,Media-Baja,74,2024-02-29,297,616,4403,14161,22195,8034
4974,2722,2646,1012,7224,3404,35043,Media-Alta,75,2024-02-29,620,805,7969,23407,43012,19605
3327,1984,1235,570,5135,1335,17853,Media-Baja,76,2024-02-29,302,672,5866,14560,23719,9159
3194,1856,1227,636,6245,1757,17314,Media-Baja,77,2024-02-29,261,695,5190,15871,22504,6633
4178,3815,2716,1137,7253,2940,35196,Media-Alta,79,2024-02-29,678,1010,7251,23727,42447,18720
4826,3157,2131,1448,5997,2906,40561,Media-Alta,80,2024-02-29,635,1096,8533,22196,49094,26898
3107,1921,1197,547,5609,1607,20416,Media-Baja,81,2024-02-29,273,621,4235,14882,24651,9769
1358,1080,443,276,4350,642,11064,Baja,82,2024-02-29,188,180,937,8517,12001,3484
1658,1041,502,261,3623,680,10331,Baja,83,2024-02-29,197,220,858,8182,11189,3007
3094,1711,1290,611,5692,1637,17581,Media-Baja,84,2024-02-29,303,647,4807,14985,22388,7403
1477,930,542,242,4404,876,9415,Baja,85,2024-02-29,183,198,860,8852,10275,1423
1636,712,406,231,4673,850,9888,Baja,86,2024-02-29,198,188,748,8894,10636,1742
3688,1806,1197,612,5554,1657,16331,Media-Baja,87,2024-02-29,288,682,5033,15484,21364,5880
2862,2165,1221,542,6510,1545,17523,Media-Baja,88,2024-02-29,300,725,5562,15870,23085,7215
1400,1085,391,251,4014,916,10141,Baja,89,2024-02-29,186,142,697,8385,10838,2453
1452,1006,398,283,4164,703,8433,Baja,90,2024-02-29,196,177,782,8379,9215,836
3212,1520,1341,617,5742,1246,17773,Media-Baja,91,2024-02-29,307,631,4869,14616,22642,8026
4316,3589,2892,1463,6899,3212,38000,Media-Alta,92,2024-02-29,701,873,8248,23945,46248,22303
3150,2074,1263,702,6904,1528,18240,Media-Baja,93,2024-02-29,335,682,4549,16638,22789,6151
3011,1885,1427,666,5574,1633,16868,Media-Baja,94,2024-02-29,301,606,5290,15103,22158,7055
4010,1791,1241,677,5738,1844,21641,Media-Baja,95,2024-02-29,281,682,4504,16264,26145,9881
1713,965,451,282,4863,831,10100,Baja,96,2024-02-29,197,176,691,9478,10791,1313
3234,1890,1411,532,4608,1520,17631,Media-Baja,97,2024-02-29,328,587,4501,14110,22132,8022
1438,881,427,218,3848,697,10653,Baja,98,2024-02-29,181,201,998,7891,11651,3760
3315,1760,1196,616,5899,1551,18485,Media-Baja,99,2024-02-29,327,618,5742,15282,24227,8945
4663,3342,2264,1257,7139,2962,30022,Media-Alta,0,2024-03-31,670,1030,8297,23327,38319,14992
1393,1006,482,211,4358,710,8724,Baja,1,2024-03-31,200,143,856,8503,9580,1077
3270,1618,1035,650,5918,1447,17133,Media-Baja,2,2024-03-31,300,652,4227,14890,21360,6470
4994,3122,2670,1263,5617,3549,38989,Media-Alta,3,2024-03-31,705,727,7266,22647,46255,23608
1602,985,373,210,3863,713,11840,Baja,4,2024-03-31,148,182,851,8076,12691,4615
3246,2016,1275,593,5061,1517,18073,Media-Baja,5,2024-03-31,243,581,4069,14532,22142,7610
2916,1820,1122,545,5845,1967,18897,Media-Baja,6,2024-03-31,321,620,5033,15156,23930,8774
5405,4701,3522,2660,10253,5465,101228,Alta,7,2024-03-31,7414,4724,18979,44144,120207,76063
5106,3099,3050,1317,9035,3209,38839,Media-Alta,8,2024-03-31,561,887,7957,26264,46796,20532
5402,3894,3869,2416,9907,5329,92648,Alta,9,2024-03-31,6292,5090,16324,42199,108972,66773
3145,1745,1441,705,6232,1588,20530,Media-Baja,10,2024-03-31,317,610,4032,15783,24562,8779
2746,1884,1427,583,6047,1617,17484,Media-Baja,11,2024-03-31,315,732,5043,15351,22527,7176
3460,1892,1275,726,6337,1657,18986,Media-Baja,12,2024-03-31,348,561,4576,16256,23562,7306
4690,4086,2655,1231,6510,3187,41019,Media-Alta,13,2024-03-31,575,1003,8004,23937,49023,25086
3265,1919,1141,572,6444,1576,16336,Media-Baja,14,2024-03-31,316,522,4983,15755,21319,5564
1642,708,473,238,4834,758,8877,Baja,15,2024-03-31,203,183,780,9039,9657,618
2864,1822,1340,705,6457,1626,17209,Media-Baja,16,2024-03-31,308,566,5060,15688,22269,6581
3264,1932,1132,650,5375,1377,18612,Media-Baja,17,2024-03-31,285,612,5219,14627,23831,9204
3514,1703,1071,558,5064,1331,20939,Media-Baja,18,2024-03-31,307,606,5425,14154,26364,12210
3397,1753,1181,615,6505,1575,18541,Media-Baja,19,2024-03-31,360,606,4836,15992,23377,7385
3041,1678,1026,632,5564,1546,21114,Media-Baja,20,2024-03-31,338,715,5006,14540,26120,11580
4466,3382,2441,1418,6767,3524,34839,Media-Alta,21,2024-03-31,491,876,7929,23365,42768,19403
5530,4451,2487,1161,5795,3918,42424,Media-Alta,22,2024-03-31,623,918,7746,24883,50170,25287
2781,1683,1278,612,5598,1956,20461,Media-Baja,23,2024-03-31,361,622,4971,14891,25432,10541
1683,993,447,203,3821,660,10235,Baja,24,2024-03-31,177,215,923,8199,11158,2959
6819,5534,4610,1954,11147,5842,75308,Alta,25,2024-03-31,6717,6195,20192,48818,95500,46682
5009,3734,2897,1440,7018,3252,33934,Media-Alta,26,2024-03-31,710,1055,8540,25115,42474,17359
1697,970,435,270,3765,773,9721,Baja,27,2024-03-31,148,158,876,8216,10597,2381
4860,3429,2397,1193,6958,3329,46354,Media-Alta,28,2024-03-31,672,796,6920,23634,53274,29640
1430,851,428,271,4469,826,10603,Baja,29,2024-03-31,203,187,898,8665,11501,2836
2977,1753,1288,532,4861,1817,19408,Media-Baja,30,2024-03-31,326,545,4710,14099,24118,10019
4081,4350,2374,1375,7509,3059,34641,Media-Alta,31,2024-03-31,471,981,7207,24200,41848,17648
1787,998,443,283,4718,637,9651,Baja,32,2024-03-31,187,202,714,9255,10365,1110
6682,5434,3675,2105,10759,5285,74485,Alta,33,2024-03-31,6285,6299,17546,46524,92031,45507
2674,1917,1221,606,4121,1218,20116,Media-Baja,34,2024-03-31,372,551,5571,12680,25687,13007
3074,2057,1293,556,5552,1215,18388,Media-Baja,35,2024-03-31,330,520,5385,14597,23773,9176
3059,1862,1007,671,4439,1516,18677,Media-Baja,36,2024-03-31,312,642,4752,13508,23429,9921
3047,1573,1297,716,5424,1568,18988,Media-Baja,37,2024-03-31,303,592,5146,14520,24134,9614
2646,2009,1117,527,6192,1628,18380,Media-Baja,38,2024-03-31,283,601,4421,15003,22801,7798
7658,5254,3623,2392,9942,4665,92506,Alta,39,2024-03-31,5478,6962,17797,45974,110303,64329
5768,3864,4360,2077,11066,5174,87239,Alta,40,2024-03-31,6084,5597,17370,43990,104609,60619
6385,4958,3604,2347,12708,4965,83686,Alta,41,2024-03-31,6479,6135,20023,47581,103709,56128
4816,3116,2474,1448,6417,2846,37090,Media-Alta,42,2024-03-31,583,807,8454,22507,45544,23037
6770,4965,3805,2311,9227,4625,98697,Alta,43,2024-03-31,6708,5160,16028,43571,114725,71154
7767,5303,4821,1990,10492,5194,81335,Alta,44,2024-03-31,7100,5448,22324,48115,103659,55544
4215,3341,2201,1095,7207,3159,36720,Media-Alta,45,2024-03-31,591,930,7128,22739,43848,21109
4381,3435,2271,1557,6517,3042,34438,Media-Alta,46,2024-03-31,592,862,9305,22657,43743,21086
2905,1829,1263,578,5206,1730,18435,Media-Baja,47,2024-03-31,303,675,5075,14489,23510,9021
2807,1738,1333,642,4895,1363,17862,Media-Baja,48,2024-03-31,291,705,5625,13774,23487,9713
3307,2120,978,500,6359,1844,19366,Media-Baja,49,2024-03-31,312,558,5601,15978,24967,8989
3264,2181,1081,590,6142,1543,20582,Media-Baja,50,2024-03-31,300,662,4366,15763,24948,9185
1612,912,377,238,4131,708,11020,Baja,51,2024-03-31,208,137,687,8323,11707,3384
4580,3714,2307,1052,5952,3099,41175,Media-Alta,52,2024-03-31,637,872,7673,22213,48848,26635
1598,1038,415,217,4191,790,10238,Baja,53,2024-03-31,181,173,832,8603,11070,2467
5091,3311,2690,1342,8432,2665,37340,Media-Alta,54,2024-03-31,685,991,6532,25207,43872,18665
3166,1894,1162,656,4809,1606,20467,Media-Baja,55,2024-03-31,298,566,4043,14157,24510,10353
1617,827,421,287,4344,746,10402,Baja,56,2024-03-31,171,202,804,8615,11206,2591
3127,2100,1276,530,5083,1225,18071,Media-Baja,57,2024-03-31,283,697,5058,14321,23129,8808
2885,2290,1167,602,5643,1555,20171,Media-Baja,58,2024-03-31,322,622,4705,15086,24876,9790
3868,3089,2544,1156,6042,3105,39061,Media-Alta,59,2024-03-31,652,982,8092,21438,47153,25715
3047,1809,1281,835,5632,1472,18257,Media-Baja,60,2024-03-31,285,565,5044,14926,23301,8375
2509,1894,1503,745,5483,1407,17457,Media-Baja,61,2024-03-31,321,540,4782,14402,22239,7837
4144,3681,2389,1340,7050,2879,32348,Media-Alta,62,2024-03-31,633,790,7703,22906,40051,17145
3101,1934,1300,635,6515,1622,17657,Media-Baja,63,2024-03-31,268,750,5611,16125,23268,7143
4511,3266,2127,1120,6360,3356,29932,Media-Alta,64,2024-03-31,625,1002,7350,22367,37282,14915
5719,3492,2931,1182,8307,2464,38335,Media-Alta,65,2024-03-31,458,881,7664,25434,45999,20565
4176,3700,2441,1237,6014,3452,38669,Media-Alta,66,2024-03-31,595,901,7342,22516,46011,23495
5290,3905,2757,1295,7646,2832,34956,Media-Alta,67,2024-03-31,602,851,8210,25178,43166,17988
1510,890,413,252,4908,791,11291,Baja,69,2024-03-31,218,188,772,9170,12063,2893
3084,2141,1388,620,5230,1752,16398,Media-Baja,70,2024-03-31,333,595,5430,15143,21828,6685
6373,4829,3936,2455,9486,4169,78812,Alta,71,2024-03-31,5955,5198,17074,42401,95886,53485
1565,1077,415,257,4173,791,10581,Baja,72,2024-03-31,187,167,797,8632,11378,2746
1702,916,526,260,4636,753,10416,Baja,73,2024-03-31,155,188,877,9136,11293,2157
2970,1697,1338,636,5535,1072,17792,Media-Baja,74,2024-03-31,338,708,4388,14294,22180,7886
4974,2722,2646,1012,7224,3404,35043,Media-Alta,75,2024-03-31,470,827,9466,23279,44509,21230
3327,1984,1235,570,5135,1335,17853,Media-Baja,76,2024-03-31,265,657,4876,14508,22729,8221
3194,1856,1227,636,6245,1757,17314,Media-Baja,77,2024-03-31,335,632,4891,15882,22205,6323
4178,3815,2716,1137,7253,2940,35196,Media-Alta,79,2024-03-31,566,851,7987,23456,43183,19727
4826,3157,2131,1448,5997,2906,40561,Media-Alta,80,2024-03-31,613,1013,7333,22091,47894,25803
3107,1921,1197,547,5609,1607,20416,Media-Baja,81,2024-03-31,355,655,4484,14998,24900,9902
1358,1080,443,276,4350,642,11064,Baja,82,2024-03-31,188,223,689,8560,11753,3193
1658,1041,502,261,3623,680,10331,Baja,83,2024-03-31,211,190,770,8166,11101,2935
3094,1711,1290,611,5692,1637,17581,Media-Baja,84,2024-03-31,327,483,5427,14845,23008,8163
1477,930,542,242,4404,876,9415,Baja,85,2024-03-31,200,216,754,8887,10169,1282
1636,712,406,231,4673,850,9888,Baja,86,2024-03-31,187,208,877,8903,10765,1862
3688,1806,1197,612,5554,1657,16331,Media-Baja,87,2024-03-31,323,692,5088,15529,21419,5890
2862,2165,1221,542,6510,1545,17523,Media-Baja,88,2024-03-31,330,607,4309,15782,21832,6050
1400,1085,391,251,4014,916,10141,Baja,89,2024-03-31,207,165,928,8429,11069,2640
1452,1006,398,283,4164,703,8433,Baja,90,2024-03-31,161,162,944,8329,9377,1048
3212,1520,1341,617,5742,1246,17773,Media-Baja,91,2024-03-31,272,647,5254,14597,23027,8430
4316,3589,2892,1463,6899,3212,38000,Media-Alta,92,2024-03-31,751,985,7915,24107,45915,21808
3150,2074,1263,702,6904,1528,18240,Media-Baja,93,2024-03-31,330,696,4407,16647,22647,6000
3011,1885,1427,666,5574,1633,16868,Media-Baja,94,2024-03-31,343,601,5817,15140,22685,7545
4010,1791,1241,677,5738,1844,21641,Media-Baja,95,2024-03-31,312,620,4784,16233,26425,10192
1713,965,451,282,4863,831,10100,Baja,96,2024-03-31,202,138,749,9445,10849,1404
3234,1890,1411,532,4608,1520,17631,Media-Baja,97,2024-03-31,343,672,5194,14210,22825,8615
1438,881,427,218,3848,697,10653,Baja,98,2024-03-31,152,218,812,7879,11465,3586
3315,1760,1196,616,5899,1551,18485,Media-Baja,99,2024-03-31,290,657,4453,15284,22938,7654
4663,3342,2264,1257,7139,2962,30022,Media-Alta,0,2024-04-30,652,961,7671,23240,37693,14453
1393,1006,482,211,4358,710,8724,Baja,1,2024-04-30,191,172,754,8523,9478,955
3270,1618,1035,650,5918,1447,17133,Media-Baja,2,2024-04-30,268,636,5814,14842,22947,8105
4994,3122,2670,1263,5617,3549,38989,Media-Alta,3,2024-04-30,667,1106,8482,22988,47471,24483
1602,985,373,210,3863,713,11840,Baja,4,2024-04-30,197,167,1037,8110,12877,4767
3246,2016,1275,593,5061,1517,18073,Media-Baja,5,2024-04-30,276,751,6059,14735,24132,9397
2916,1820,1122,545,5845,1967,18897,Media-Baja,6,2024-04-30,257,562,4881,15034,23778,8744
5405,4701,3522,2660,10253,5465,101228,Alta,7,2024-04-30,6988,5101,18211,44095,119439,75344
5106,3099,3050,1317,9035,3209,38839,Media-Alta,8,2024-04-30,577,1005,8413,26398,47252,20854
5402,3894,3869,2416,9907,5329,92648,Alta,9,2024-04-30,6300,4823,14967,41940,107615,65675
3145,1745,1441,705,6232,1588,20530,Media-Baja,10,2024-04-30,341,585,5369,15782,25899,10117
2746,1884,1427,583,6047,1617,17484,Media-Baja,11,2024-04-30,280,523,4675,15107,22159,7052
3460,1892,1275,726,6337,1657,18986,Media-Baja,12,2024-04-30,337,600,4412,16284,23398,7114
4690,4086,2655,1231,6510,3187,41019,Media-Alta,13,2024-04-30,502,1063,8608,23924,49627,25703
3265,1919,1141,572,6444,1576,16336,Media-Baja,14,2024-04-30,321,547,6126,15785,22462,6677
1642,708,473,238,4834,758,8877,Baja,15,2024-04-30,175,175,936,9003,9813,810
2864,1822,1340,705,6457,1626,17209,Media-Baja,16,2024-04-30,330,646,4459,15790,21668,5878
3264,1932,1132,650,5375,1377,18612,Media-Baja,17,2024-04-30,297,543,5454,14570,24066,9496
3514,1703,1071,558,5064,1331,20939,Media-Baja,18,2024-04-30,322,595,5443,14158,26382,12224
3397,1753,1181,615,6505,1575,18541,Media-Baja,19,2024-04-30,297,613,6596,15936,25137,9201
3041,1678,1026,632,5564,1546,21114,Media-Baja,20,2024-04-30,392,686,5490,14565,26604,12039
4466,3382,2441,1418,6767,3524,34839,Media-Alta,21,2024-04-30,610,1108,7255,23716,42094,18378
5530,4451,2487,1161,5795,3918,42424,Media-Alta,22,2024-04-30,768,907,8480,25017,50904,25887
2781,1683,1278,612,5598,1956,20461,Media-Baja,23,2024-04-30,313,547,4563,14768,25024,10256
1683,993,447,203,3821,660,10235,Baja,24,2024-04-30,190,161,792,8158,11027,2869
6819,5534,4610,1954,11147,5842,75308,Alta,25,2024-04-30,5492,6582,14968,47980,90276,42296
5009,3734,2897,1440,7018,3252,33934,Media-Alta,26,2024-04-30,525,991,8958,24866,42892,18026
1697,970,435,270,3765,773,9721,Baja,27,2024-04-30,206,180,826,8296,10547,2251
4860,3429,2397,1193,6958,3329,46354,Media-Alta,28,2024-04-30,726,963,8446,23855,54800,30945
1430,851,428,271,4469,826,10603,Baja,29,2024-04-30,207,177,692,8659,11295,2636
2977,1753,1288,532,4861,1817,19408,Media-Baja,30,2024-04-30,350,650,5826,14228,25234,11006
4081,4350,2374,1375,7509,3059,34641,Media-Alta,31,2024-04-30,626,873,8624,24247,43265,19018
1787,998,443,283,4718,637,9651,Baja,32,2024-04-30,162,231,879,9259,10530,1271
6682,5434,3675,2105,10759,5285,74485,Alta,33,2024-04-30,7354,5533,17047,46827,91532,44705
2674,1917,1221,606,4121,1218,20116,Media-Baja,34,2024-04-30,283,490,4037,12530,24153,11623
3074,2057,1293,556,5552,1215,18388,Media-Baja,35,2024-04-30,326,541,5371,14614,23759,9145
3059,1862,1007,671,4439,1516,18677,Media-Baja,36,2024-04-30,337,715,5711,13606,24388,10782
3047,1573,1297,716,5424,1568,18988,Media-Baja,37,2024-04-30,311,661,4080,14597,23068,8471
2646,2009,1117,527,6192,1628,18380,Media-Baja,38,2024-04-30,320,641,5205,15080,23585,8505
7658,5254,3623,2392,9942,4665,92506,Alta,39,2024-04-30,7443,6690,18981,47667,111487,63820
5768,3864,4360,2077,11066,5174,87239,Alta,40,2024-04-30,6895,5482,17802,44686,105041,60355
6385,4958,3604,2347,12708,4965,83686,Alta,41,2024-04-30,5672,6232,18724,46871,102410,55539
4816,3116,2474,1448,6417,2846,37090,Media-Alta,42,2024-04-30,507,990,8024,22614,45114,22500
6770,4965,3805,2311,9227,4625,98697,Alta,43,2024-04-30,6095,5080,17867,42878,116564,73686
7767,5303,4821,1990,10492,5194,81335,Alta,44,2024-04-30,6220,5540,15305,47327,96640,49313
4215,3341,2201,1095,7207,3159,36720,Media-Alta,45,2024-04-30,636,903,9154,22757,45874,23117
4381,3435,2271,1557,6517,3042,34438,Media-Alta,46,2024-04-30,671,805,7776,22679,42214,19535
2905,1829,1263,578,5206,1730,18435,Media-Baja,47,2024-04-30,336,806,4187,14653,22622,7969
2807,1738,1333,642,4895,1363,17862,Media-Baja,48,2024-04-30,293,617,5174,13688,23036,9348
3307,2120,978,500,6359,1844,19366,Media-Baja,49,2024-04-30,323,600,3880,16031,23246,7215
3264,2181,1081,590,6142,1543,20582,Media-Baja,50,2024-04-30,335,617,5282,15753,25864,10111
1612,912,377,238,4131,708,11020,Baja,51,2024-04-30,181,191,778,8350,11798,3448
4580,3714,2307,1052,5952,3099,41175,Media-Alta,52,2024-04-30,577,870,8857,22151,50032,27881
1598,1038,415,217,4191,790,10238,Baja,53,2024-04-30,175,190,953,8614,11191,2577
5091,3311,2690,1342,8432,2665,37340,Media-Alta,54,2024-04-30,550,838,7836,24919,45176,20257
3166,1894,1162,656,4809,1606,20467,Media-Baja,55,2024-04-30,292,660,4748,14245,25215,10970
1617,827,421,287,4344,746,10402,Baja,56,2024-04-30,221,195,888,8658,11290,2632
3127,2100,1276,530,5083,1225,18071,Media-Baja,57,2024-04-30,308,685,5775,14334,23846,9512
2885,2290,1167,602,5643,1555,20171,Media-Baja,58,2024-04-30,320,656,4233,15118,24404,9286
3868,3089,2544,1156,6042,3105,39061,Media-Alta,59,2024-04-30,518,863,6883,21185,45944,24759
3047,1809,1281,835,5632,1472,18257,Media-Baja,60,2024-04-30,335,603,4767,15014,23024,8010
2509,1894,1503,745,5483,1407,17457,Media-Baja,61,2024-04-30,292,700,4518,14533,21975,7442
4144,3681,2389,1340,7050,2879,32348,Media-Alta,62,2024-04-30,562,927,8659,22972,41007,18035
3101,1934,1300,635,6515,1622,17657,Media-Baja,63,2024-04-30,253,608,4554,15968,22211,6243
4511,3266,2127,1120,6360,3356,29932,Media-Alta,64,2024-04-30,590,980,6643,22310,36575,14265
5719,3492,2931,1182,8307,2464,38335,Media-Alta,65,2024-04-30,697,945,7522,25737,45857,20120
4176,3700,2441,1237,6014,3452,38669,Media-Alta,66,2024-04-30,542,803,8614,22365,47283,24918
5290,3905,2757,1295,7646,2832,34956,Media-Alta,67,2024-04-30,587,817,7868,25129,42824,17695
1510,890,413,252,4908,791,11291,Baja,69,2024-04-30,165,186,883,9115,12174,3059
3084,2141,1388,620,5230,1752,16398,Media-Baja,70,2024-04-30,275,581,5929,15071,22327,7256
6373,4829,3936,2455,9486,4169,78812,Alta,71,2024-04-30,7029,4359,17188,42636,96000,53364
1565,1077,415,257,4173,791,10581,Baja,72,2024-04-30,190,196,862,8664,11443,2779
1702,916,526,260,4636,753,10416,Baja,73,2024-04-30,182,200,957,9175,11373,2198
2970,1697,1338,636,5535,1072,17792,Media-Baja,74,2024-04-30,347,531,4130,14126,21922,7796
4974,2722,2646,1012,7224,3404,35043,Media-Alta,75,2024-04-30,695,1097,7653,23774,42696,18922
3327,1984,1235,570,5135,1335,17853,Media-Baja,76,2024-04-30,332,558,4681,14476,22534,8058
3194,1856,1227,636,6245,1757,17314,Media-Baja,77,2024-04-30,308,598,5032,15821,22346,6525
4178,3815,2716,1137,7253,2940,35196,Media-Alta,79,2024-04-30,636,955,7844,23630,43040,19410
4826,3157,2131,1448,5997,2906,40561,Media-Alta,80,2024-04-30,522,982,6901,21969,47462,25493
3107,1921,1197,547,5609,1607,20416,Media-Baja,81,2024-04-30,328,683,5072,14999,25488,10489
1358,1080,443,276,4350,642,11064,Baja,82,2024-04-30,178,191,770,8518,11834,3316
1658,1041,502,261,3623,680,10331,Baja,83,2024-04-30,208,182,785,8155,11116,2961
3094,1711,1290,611,5692,1637,17581,Media-Baja,84,2024-04-30,316,647,4421,14998,22002,7004
1477,930,542,242,4404,876,9415,Baja,85,2024-04-30,187,221,800,8879,10215,1336
1636,712,406,231,4673,850,9888,Baja,86,2024-04-30,161,172,914,8841,10802,1961
3688,1806,1197,612,5554,1657,16331,Media-Baja,87,2024-04-30,311,746,5112,15571,21443,5872
2862,2165,1221,542,6510,1545,17523,Media-Baja,88,2024-04-30,321,690,4019,15856,21542,5686
1400,1085,391,251,4014,916,10141,Baja,89,2024-04-30,178,166,985,8401,11126,2725
1452,1006,398,283,4164,703,8433,Baja,90,2024-04-30,181,192,781,8379,9214,835
3212,1520,1341,617,5742,1246,17773,Media-Baja,91,2024-04-30,302,607,5188,14587,22961,8374
4316,3589,2892,1463,6899,3212,38000,Media-Alta,92,2024-04-30,561,957,7263,23889,45263,21374
3150,2074,1263,702,6904,1528,18240,Media-Baja,93,2024-04-30,328,630,5004,16579,23244,6665
3011,1885,1427,666,5574,1633,16868,Media-Baja,94,2024-04-30,263,620,5845,15079,22713,7634
4010,1791,1241,677,5738,1844,21641,Media-Baja,95,2024-04-30,283,687,4957,16271,26598,10327
1713,965,451,282,4863,831,10100,Baja,96,2024-04-30,191,200,755,9496,10855,1359
3234,1890,1411,532,4608,1520,17631,Media-Baja,97,2024-04-30,348,768,4825,14311,22456,8145
1438,881,427,218,3848,697,10653,Baja,98,2024-04-30,187,221,795,7917,11448,3531
3315,1760,1196,616,5899,1551,18485,Media-Baja,99,2024-04-30,346,602,4594,15285,23079,7794
4663,3342,2264,1257,7139,2962,30022,Media-Alta,0,2024-05-31,706,997,6771,23330,36793,13463
1393,1006,482,211,4358,710,8724,Baja,1,2024-05-31,162,176,917,8498,9641,1143
3270,1618,1035,650,5918,1447,17133,Media-Baja,2,2024-05-31,303,610,4213,14851,21346,6495
4994,3122,2670,1263,5617,3549,38989,Media-Alta,3,2024-05-31,556,1013,9237,22784,48226,25442
1602,985,373,210,3863,713,11840,Baja,4,2024-05-31,183,192,739,8121,12579,4458
3246,2016,1275,593,5061,1517,18073,Media-Baja,5,2024-05-31,340,783,4849,14831,22922,8091
2916,1820,1122,545,5845,1967,18897,Media-Baja,6,2024-05-31,306,568,5243,15089,24140,9051
5405,4701,3522,2660,10253,5465,101228,Alta,7,2024-05-31,5703,4599,15835,42308,117063,74755
5106,3099,3050,1317,9035,3209,38839,Media-Alta,8,2024-05-31,687,947,8219,26450,47058,20608
5402,3894,3869,2416,9907,5329,92648,Alta,9,2024-05-31,6763,5388,15370,42968,108018,65050
3145,1745,1441,705,6232,1588,20530,Media-Baja,10,2024-05-31,352,543,5249,15751,25779,10028
2746,1884,1427,583,6047,1617,17484,Media-Baja,11,2024-05-31,273,652,5000,15229,22484,7255
3460,1892,1275,726,6337,1657,18986,Media-Baja,12,2024-05-31,285,743,4663,16375,23649,7274
4690,4086,2655,1231,6510,3187,41019,Media-Alta,13,2024-05-31,620,1097,6953,24076,47972,23896
3265,1919,1141,572,6444,1576,16336,Media-Baja,14,2024-05-31,341,660,4759,15918,21095,5177
1642,708,473,238,4834,758,8877,Baja,15,2024-05-31,171,183,812,9007,9689,682
2864,1822,1340,705,6457,1626,17209,Media-Baja,16,2024-05-31,293,748,4675,15855,21884,6029
3264,1932,1132,650,5375,1377,18612,Media-Baja,17,2024-05-31,312,498,4912,14540,23524,8984
3514,1703,1071,558,5064,1331,20939,Media-Baja,18,2024-05-31,283,692,5190,14216,26129,11913
3397,1753,1181,615,6505,1575,18541,Media-Baja,19,2024-05-31,346,615,5674,15987,24215,8228
3041,1678,1026,632,5564,1546,21114,Media-Baja,20,2024-05-31,278,716,5306,14481,26420,11939
4466,3382,2441,1418,6767,3524,34839,Media-Alta,21,2024-05-31,608,908,8769,23514,43608,20094
5530,4451,2487,1161,5795,3918,42424,Media-Alta,22,2024-05-31,547,1126,8671,25015,51095,26080
2781,1683,1278,612,5598,1956,20461,Media-Baja,23,2024-05-31,373,633,5625,14914,26086,11172
1683,993,447,203,3821,660,10235,Baja,24,2024-05-31,210,148,927,8165,11162,2997
6819,5534,4610,1954,11147,5842,75308,Alta,25,2024-05-31,6419,5840,15360,48165,90668,42503
5009,3734,2897,1440,7018,3252,33934,Media-Alta,26,2024-05-31,682,992,7061,25024,40995,15971
1697,970,435,270,3765,773,9721,Baja,27,2024-05-31,177,186,899,8273,10620,2347
4860,3429,2397,1193,6958,3329,46354,Media-Alta,28,2024-05-31,630,836,7515,23632,53869,30237
1430,851,428,271,4469,826,10603,Baja,29,2024-05-31,166,155,820,8596,11423,2827
2977,1753,1288,532,4861,1817,19408,Media-Baja,30,2024-05-31,357,585,5088,14170,24496,10326
4081,4350,2374,1375,7509,3059,34641,Media-Alta,31,2024-05-31,685,877,8204,24310,42845,18535
1787,998,443,283,4718,637,9651,Baja,32,2024-05-31,197,181,915,9244,10566,1322
6682,5434,3675,2105,10759,5285,74485,Alta,33,2024-05-31,5585,6737,20261,46262,94746,48484
2674,1917,1221,606,4121,1218,20116,Media-Baja,34,2024-05-31,293,695,4802,12745,24918,12173
3074,2057,1293,556,5552,1215,18388,Media-Baja,35,2024-05-31,282,630,5206,14659,23594,8935
3059,1862,1007,671,4439,1516,18677,Media-Baja,36,2024-05-31,318,591,5399,13463,24076,10613
3047,1573,1297,716,5424,1568,18988,Media-Baja,37,2024-05-31,355,606,5468,14586,24456,9870
2646,2009,1117,527,6192,1628,18380,Media-Baja,38,2024-05-31,295,518,4785,14932,23165,8233
7658,5254,3623,2392,9942,4665,92506,Alta,39,2024-05-31,6753,5442,17273,45729,109779,64050
5768,3864,4360,2077,11066,5174,87239,Alta,40,2024-05-31,7198,6600,14473,46107,101712,55605
6385,4958,3604,2347,12708,4965,83686,Alta,41,2024-05-31,6390,6420,16548,47777,100234,52457
4816,3116,2474,1448,6417,2846,37090,Media-Alta,42,2024-05-31,593,1027,8748,22737,45838,23101
6770,4965,3805,2311,9227,4625,98697,Alta,43,2024-05-31,6333,5627,17372,43663,116069,72406
7767,5303,4821,1990,10492,5194,81335,Alta,44,2024-05-31,6919,6374,17472,48860,98807,49947
4215,3341,2201,1095,7207,3159,36720,Media-Alta,45,2024-05-31,670,955,8013,22843,44733,21890
4381,3435,2271,1557,6517,3042,34438,Media-Alta,46,2024-05-31,528,1053,8855,22784,43293,20509
2905,1829,1263,578,5206,1730,18435,Media-Baja,47,2024-05-31,362,636,5269,14509,23704,9195
2807,1738,1333,642,4895,1363,17862,Media-Baja,48,2024-05-31,341,581,5397,13700,23259,9559
3307,2120,978,500,6359,1844,19366,Media-Baja,49,2024-05-31,327,598,5445,16033,24811,8778
3264,2181,1081,590,6142,1543,20582,Media-Baja,50,2024-05-31,295,657,4597,15753,25179,9426
1612,912,377,238,4131,708,11020,Baja,51,2024-05-31,163,156,805,8297,11825,3528
4580,3714,2307,1052,5952,3099,41175,Media-Alta,52,2024-05-31,717,891,9124,22312,50299,27987
1598,1038,415,217,4191,790,10238,Baja,53,2024-05-31,206,207,865,8662,11103,2441
5091,3311,2690,1342,8432,2665,37340,Media-Alta,54,2024-05-31,598,835,8543,24964,45883,20919
3166,1894,1162,656,4809,1606,20467,Media-Baja,55,2024-05-31,286,706,5424,14285,25891,11606
1617,827,421,287,4344,746,10402,Baja,56,2024-05-31,197,206,857,8645,11259,2614
3127,2100,1276,530,5083,1225,18071,Media-Baja,57,2024-05-31,303,606,4675,14250,22746,8496
2885,2290,1167,602,5643,1555,20171,Media-Baja,58,2024-05-31,286,672,4410,15100,24581,9481
3868,3089,2544,1156,6042,3105,39061,Media-Alta,59,2024-05-31,581,1061,6166,21446,45227,23781
3047,1809,1281,835,5632,1472,18257,Media-Baja,60,2024-05-31,303,503,5824,14882,24081,9199
2509,1894,1503,745,5483,1407,17457,Media-Baja,61,2024-05-31,328,517,5428,14386,22885,8499
4144,3681,2389,1340,7050,2879,32348,Media-Alta,62,2024-05-31,646,1101,7782,23230,40130,16900
3101,1934,1300,635,6515,1622,17657,Media-Baja,63,2024-05-31,330,660,5502,16097,23159,7062
4511,3266,2127,1120,6360,3356,29932,Media-Alta,64,2024-05-31,585,902,7225,22227,37157,14930
5719,3492,2931,1182,8307,2464,38335,Media-Alta,65,2024-05-31,572,918,7477,25585,45812,20227
4176,3700,2441,1237,6014,3452,38669,Media-Alta,66,2024-05-31,686,970,8818,22676,47487,24811
5290,3905,2757,1295,7646,2832,34956,Media-Alta,67,2024-05-31,570,938,7521,25233,42477,17244
1510,890,413,252,4908,791,11291,Baja,69,2024-05-31,206,195,863,9165,12154,2989
3084,2141,1388,620,5230,1752,16398,Media-Baja,70,2024-05-31,306,716,4753,15237,21151,5914
6373,4829,3936,2455,9486,4169,78812,Alta,71,2024-05-31,6610,6347,13663,44205,92475,48270
1565,1077,415,257,4173,791,10581,Baja,72,2024-05-31,188,186,746,8652,11327,2675
1702,916,526,260,4636,753,10416,Baja,73,2024-05-31,137,173,1058,9103,11474,2371
2970,1697,1338,636,5535,1072,17792,Media-Baja,74,2024-05-31,338,640,5187,14226,22979,8753
4974,2722,2646,1012,7224,3404,35043,Media-Alta,75,2024-05-31,607,1065,9024,23654,44067,20413
3327,1984,1235,570,5135,1335,17853,Media-Baja,76,2024-05-31,288,603,5062,14477,22915,8438
3194,1856,1227,636,6245,1757,17314,Media-Baja,77,2024-05-31,305,582,5244,15802,22558,6756
4178,3815,2716,1137,7253,2940,35196,Media-Alta,79,2024-05-31,622,987,10045,23648,45241,21593
4826,3157,2131,1448,5997,2906,40561,Media-Alta,80,2024-05-31,537,1105,8350,22107,48911,26804
3107,1921,1197,547,5609,1607,20416,Media-Baja,81,2024-05-31,320,568,5112,14876,25528,10652
1358,1080,443,276,4350,642,11064,Baja,82,2024-05-31,213,183,799,8545,11863,3318
1658,1041,502,261,3623,680,10331,Baja,83,2024-05-31,221,183,872,8169,11203,3034
3094,1711,1290,611,5692,1637,17581,Media-Baja,84,2024-05-31,265,632,6240,14932,23821,8889
1477,930,542,242,4404,876,9415,Baja,85,2024-05-31,153,175,961,8799,10376,1577
1636,712,406,231,4673,850,9888,Baja,86,2024-05-31,178,166,859,8852,10747,1895
3688,1806,1197,612,5554,1657,16331,Media-Baja,87,2024-05-31,297,623,5598,15434,21929,6495
2862,2165,1221,542,6510,1545,17523,Media-Baja,88,2024-05-31,316,656,5659,15817,23182,7365
1400,1085,391,251,4014,916,10141,Baja,89,2024-05-31,182,207,849,8446,10990,2544
1452,1006,398,283,4164,703,8433,Baja,90,2024-05-31,175,213,894,8394,9327,933
3212,1520,1341,617,5742,1246,17773,Media-Baja,91,2024-05-31,307,560,4306,14545,22079,7534
4316,3589,2892,1463,6899,3212,38000,Media-Alta,92,2024-05-31,666,652,8319,23689,46319,22630
3150,2074,1263,702,6904,1528,18240,Media-Baja,93,2024-05-31,297,643,4289,16561,22529,5968
3011,1885,1427,666,5574,1633,16868,Media-Baja,94,2024-05-31,345,630,5691,15171,22559,7388
4010,1791,1241,677,5738,1844,21641,Media-Baja,95,2024-05-31,292,647,4753,16240,26394,10154
1713,965,451,282,4863,831,10100,Baja,96,2024-05-31,183,165,810,9453,10910,1457
3234,1890,1411,532,4608,1520,17631,Media-Baja,97,2024-05-31,275,667,5377,14137,23008,8871
1438,881,427,218,3848,697,10653,Baja,98,2024-05-31,165,223,871,7897,11524,3627
3315,1760,1196,616,5899,1551,18485,Media-Baja,99,2024-05-31,321,736,4704,15394,23189,7795
